в Москве; в Москву|in Moscow; to Moscow
Он не в Москве|He is not in Moscow
на работе; на стол|at work; onto the table
Я говорю|I speak/am speaking/say
Он говорит|He speaks/is speaking/says
Я говорю, что он на работе|I say that he is at work
чай с лимоном; со стола|tea with lemon; from (off) the table
Это наш клуб; Это верно|This is our club; That’s true
Быть или не быть?; Есть кофе?|To be or not to be?; Is there any coffee?
Она в Москве, а он в Петербурге|She is in Moscow, and (but) he is in St Petersburg
весь стол; вся Москва|the whole table; all of Moscow
Они в Москве|They are in Moscow
Она со мной|She is with me
Как он говорит? как я, как ты|How does he speak? like me, like you
Мы были в Петербурге|We were in St Petersburg
к дому; ко мне|towards the house; towards me
у окна; у Ивана; У Ивана есть дом|by the window; at Ivan’s house; Ivan has a house
Вы говорите|You are speaking
этот стол, эта книга, эти люди|this table, this book, these people
платить за водку за домом|to pay for the vodka; behind the house
тот дом; в то время; то, что …|that house; at that time; the fact that…
Но это не правда|But that’s not true
Ты говоришь|You are speaking
по улице; по городу; по плану|along the street; around the town; according to
из дома|out of the house
Он говорит о Москве|He is speaking about Moscow
Он говорит о своей работе|He is talking about his own work
так быстро|so quickly
один стол|one table
Вот дом|There is the house
девушка, которую он любит|the girl whom he loves
наш дом|our house
У Ивана только один брат|Ivan has only one brother
Он ещё не знает|He doesn’t know yet
письмо от Ивана|a letter from Ivan
такой большой сад|such a large garden
Я могу; Он не может говорить|I can; He can’t speak; Я смогу приехать завтра; Он не сможет ответить на ваш вопрос|I shall be able to come tomorrow; He won’t be able to answer your question
Я могу говорить|I can speak
Я сказал, что он в Москве; Скажите, пожалуйста|I said that he is in Moscow; Tell me, please
письмо для Ивана|a letter for Ivan
Он уже знает об этом|He already knows about this
Я знаю её|I know her
Да, это правда; он да я|Yes, that’s true; he and I
Какой у Ивана дом?|What kind of house has Ivan got?
Когда вы были в Москве?|When were you in Moscow?
в другом доме|in a different (another) house
в первом доме|in the first house
чтобы говорить по-русски|in order to speak Russian
Это его книга?|Is this his book?
в этом году|this year
Я знаю, кто он|I know who he is
Это моё дело|This is my business
Нет работы|There is no work
Вот её дом|There’s her house
очень большой город|a very large town
большие города|large towns
С Новым годом!|Happy New Year
Он стал говорить; Она стала инженером|He began to speak; She became an engineer
Он говорит о своей работе|He is speaking about his work
Он сейчас в Москве|He’s in Moscow at the moment
в то время; во время войны; много времени|at that time; during the war; a lot of time
Она хороший человек|She is a good person
Я иду по улице; Куда ты идёшь?|I am walking along the street; Where are you going?; Я пошёл домой|I went home
Если она хочет, я тоже хочу|If she wants (to), I want (to) too
два часа; две машины|two o’clock; two cars
Вот мой дом|There is my house
Наша жизнь хорошая|Our life is good
До свидания!|Until we meet again=Goodbye
Он знает, где мой дом|He knows where my house is
каждый день|each (every) day
самый большой дом|the biggest house
Я хочу говорить по-русски; ты хочешь; Что вы хотите?|I want to speak Russian; you want; What do you want?
Я здесь уже два года|I have been here for two years
Надо говорить по-русски|One must speak Russian
Русские - хорошие люди|Russians are good people
Теперь надо идти|Now it is necessary to go (Now we must leave)
из дома; дома|from the house; houses
один раз; два раза; шесть раз|once; twice; six times
только один день; два дня|only one day; two days
Быть или не быть|To be or not to be
Они работают в этом городе|They work in this town
Жизнь там хорошая.|Life is good there
Я скажу одно слово|I shall say one word
два глаза; большие глаза|two eyes; large eyes
Он был в моём доме, потом он пошёл на работу|He was in my house, then he went to work
Я вижу дом; Ты видишь её?|I see the house; Can you see her?
в их доме|in their house
под домом|under the house
Даже Иван знает это|Even Ivan knows that
Они думают о жизни|They think about life; Она не подумала о нём|She didn’t think about him
Очень хорошо!|Very good!
Можно идти?|Is it possible to go?
Иван тут, в нашем доме|Ivan is here, in our house
две тысячи слов|two thousand words
Знаете ли вы Ивана? Я не знаю, здесь ли он|Do you know Ivan? I don’t know whether he’s here
водка с водой; пить воду|vodka with water; to drink water
Ничто его не интересует; Он ничего не знает|Nothing interests him; He knows nothing
много работы|a lot of work
моя рука|my hand/arm
к себе; с собой|towards oneself; with oneself
молодые люди|young people
Он тоже ничего не сказал|He too said nothing
i Он спрашивает о войне|He asks about the war; p Я спросил его, знает ли он Ивана|I asked him whether he knew Ivan
без молока|without milk
Мы ничего не делаем|We are doing nothing; Он сделал всю работу|He did all the work
три часа|three o’clock/three hours
Он всё говорит о работе|He talks about work all the time
то есть; Если он здесь, то я уйду|that is (=i.e.); If he’s here, then I’ll leave
i Я хочу жить там, где она живёт|I want to live where she lives; p поживу, поживёшь, past пожил, пожила, пожило
с трудом|with difficulty
Он всё сделал сам|He did everything himself
Это хорошее вино|This is good wine
второй день нового года|the second day of the New Year
через улицу; через час|across the street; in an hour’s time
Здесь нет места|There is no place/room here
После работы мы идём домой|After work we go home
в нашей стране|in our country
двадцать домов|twenty houses
Она должна идти; Мы должны быть там в десять|She must (is obliged to) go; We ought to be there at ten
Он знает больше; больше хлеба|He knows more; more bread
Дом ваш|The house is yours
за дверью|behind the door
Мы с другом были в Москве|My friend and I were in Moscow
Мы смотрели на вашу машину|We were looking at your car
В комнате холодно|It’s cold in the room
Иван учится в университете|Ivan studies at university
над домом|above the house
над вашей головой|above your head
Почему вы не знаете?|Why don’t you know?
жизнь на земле|life on earth
Он сидит за столом|He is sitting behind (at) the table
Мы даём слово, что всё сделаем|We give (our) word that we shall do everything
Он стоит перед домом|He is standing in front of the house
Он тогда работал на заводе|He worked in a factory then
Кто сидит в комнате?|Who is sitting in the room?; p посижу, посидишь
В комнате сидят мальчики|The boys are sitting in the room
К Ивану пришла девушка|A girl has come to (see) Ivan
лётом; тысяча лет|in the summer; 1,000 years
Сегодня надо работать|Today one must work
на этой стороне|on this side
Машина совсем новая|The car is completely new
Они живут в маленьком доме|They live in a small house
несколько девушек|a few girls
Вдруг он спросил о Сталине|Suddenly he asked about Stalin
ни ... ни ...; Не было ни одного|neither ... nor ...; There wasn’t a single one
Я знаю ваше лицо|I know your face
Конечно нет!|Of course not!
русский народ|the Russian people
Мы начинаем понимать|We are beginning to understand; Он начал говорить|He began to speak
Он живёт здесь уже пять лет|He has been living here for five years already
Ведь он мой друг!|He’s my friend, you know!
трудные вопросы|difficult questions
Мальчик пишет|The boy is writing; я напишу, ты напишешь|I’ll write, you’ll write
Я пишу письмо|I am writing a letter
при мне; при Сталине; при заводе|in my presence; under Stalin; attached to the factory
машина моей матери|my mother’s car
Мне нужно идти|I must go
Она смотрит телевизор|She is watching television; Мы посмотрим фильм; Он посмотрел на меня|We’ll watch the film; He looked at me
сила характера; демократические силы|strength of character; democratic forces
Мы пришли вместе|We arrived together
Она вышла из комнаты|She went out of the room; Я выхожу из дома; Ты тоже выходишь|I leave the house; You leave too
Я люблю работать; Она вас любит|I like working; She loves you; p полюблю, полюбишь
по дороге домой|on the road (way) home
Она любит старые картины|She likes old pictures
Она живёт на нашей улице|She lives in our street
Она решила уйти; Кто решит задачу?|She decided to leave; Who will solve the problem?
На столе лежат пять книг|There are five books on the table
Всегда так|It is always like that
Голос у неё хороший|She has a good voice
Что это значит?|What does this mean?
Она ответила сразу|She answered at once
Это лишь одна из причин|That’s only one of the reasons
Я приду через три минуты|I shall come in three minutes’ time
Он начал снова|He began again
Окно открыто|The window is open
Если бы она знала, она бы помогла|If she had known, she would have helped
Вы уходите?|Are you leaving?; Он ушёл из университета|He has left the university
тысяча девятьсот пятый год|(the year) 1905
в последней комнате|in the last room
Мы проходили мимо завода|We were walking past a factory; Пройдите в комнату! Она прошла мимо него|Go through into the room! She walked past him
Она не думает об отце|She doesn’t think about (her) father
три часа|three hours; three o’clock
Они просто не знают|They simply don’t know
Я увижу её; Она увидела отца|I’ll see her; She saw her father
Как же так?; Где же она? тот же дом|But how can that be?; Where on earth is she?; the same house
Кто живёт в третьей квартире?|Who lives in flat number 3?
Я ушёл, потому что он там|I left because he is there
Никто не знает|Nobody knows
я жду; он ждёт; Ждите ответа!|I am waiting; he is waiting; Wait for an answer! /p подожду, подождёшь
Сколько лет?|How many years?
высокая девушка|a tall girl
Он говорит лучше, чем вы|Не speaks better than you
Ты получишь письмо завтра|You will receive the letter tomorrow
почти год|almost a year
В лесу тихо|It’s quiet in the forest
конец света; в конце года|the end of the world; at the end of the year
Ох, мой ноги|Oh, my feet
собственными глазами|with one’s own eyes
сто долларов; больше ста|a hundred dollars; more than a hundred
молодые художники|young artists
четыре времени года|four seasons
пока он здесь|while he is here
пока он не придёт|until he comes
Он слушает музыку|He is listening to music
по пути|on the way
белые дома|white houses
федеральная республика|federal republic
Мы шли быстро|We were walking quickly
Куда они пошли?|Where have they gone?
Вот главная улица|Here is the main street
У них нет детей|They have no children
i Он рассказывал о войне|He was talking about the war; p Я расскажу вам историю; Он рассказал нам о них|I’ll tell you a story; He talked about them
хороший совет|a good piece of advice
Мы читали газету|We were reading the newspaper
Никто не понимает|Nobody understands; Вы меня не поняли|You haven’t understood me
Пора идти|It is time to go
Я получил твоё письмо|I have received your letter
Он часто бывает здесь|He is often here
i: нахожу, находишь; Она нашла книгу?|Did she find the book?
песня о лёте|a song about summer
Как ваше имя?|What is your name? g sg имени
лидер партии|party leader
летние вечера|summer evenings
Почему вы опять здесь?|Why are you here again?
иметь право что-то сделать|to have the right to do something
между городом и лесом|between the town and the wood
настоящий друг; настоящее время|a real friend; the present time
Какие у вас планы?|What are your plans?
Он сказал правду|He told the truth
сорок человек|forty people
ходить в школу; Вчера мы ходили в кино; Я ходил по городу|to attend school; We went to the cinema yesterday; I walked round the town; p: схожу, сходишь
ходить в школу; Вчера мы ходили в кино; Я ходил по городу|to attend school; We went to the cinema yesterday; I walked round the town
i узнаю, узнаёшь; Я узнаю её; Мы узнали, где она живёт|I shall recognize her; We found out where she lives
работать в поле|to work in the field
Спокойной ночи!|Peaceful night (Goodnight)
Входите!|Come in!; я войду; я вошёл|I shall enter; I entered
Красная площадь|Red Square
более интересная книга|a more interesting book
уроки русского языка|Russian lessons
Вам нельзя курить здесь|You can’t smoke here
части тела|parts of the body
Она сидела рядом со мной|She was sitting next to me
i Газета лежит на столе|The paper is lying on the table; p p полежу, полежишь
Он слышал про эту книгу|Не has heard about this book
интересные друзья|interesting friends
Мы никогда не найдём их|We shall never find them
в этом районе|in this region
Всё, что нужно|Everything that is necessary
особенно высокий дом|an unusually tall house
Он отвечает на вопрос|He answers the question; Я отвечу на вопрос|I shall answer the question
Им нельзя говорить с начальником|They can’t speak to the boss
в разных странах|in various countries
тридцать художников|thirty artists
в десяти республиках|in ten republics
мир во всём мире|peace in the whole world
книга с картинами|a book with pictures
Центральный комитет|the Central Committee
интересная мысль|an interesting thought
принимать гостей|to receive guests
старший сын|elder son
вид на море; вид спорта|sea view; type of sport
среди друзей|among friends
В таком случае я пойду к начальнику|In that case I shall go to the boss
народная песня|folk song
Я помню её; Ты помнишь об этом?|I remember her; Do you remember that?
Прошу вас не курить; Он просит вас зайти|I ask you not to smoke; He asks you to call; p: попрошу, попросишь; Я попросил его войти I asked him to come in
Пусть идёт, если хочет|Let him go if he wants to
разговор о погоде|conversation about the weather
сидеть во дворе|to sit in the yard
Она сидела долго|She sat for a long time
три месяца; пять месяцев|3 months; 5 months
p я вернусь, ты вернёшься|I’ll return, you’ll return
профсоюз|trade union
во время войны|during the war
Они вернутся, хотя не хотят|They will return although they don’t want to
на берегу; берега реки|on the shore; banks of a river
Он ничего не делал целый день|He did nothing all day
Они вернулись группами|They returned in groups
Я скоро вернусь|I shall come back soon
Разговор со студентами|A talk with the students
школьные товарищи|schoolmates
части света|parts of the world
я сплю, ты спишь|I am asleep, you are asleep
жить полной жизнью|to live a full life
Идите сюда!|Come here!
Через два месяца он приедет в Лондон|In two months time, he will come to London
- Где письмо? - Вот оно|- Where’s the letter? -There it is
русские женщины|Russian women
на собрании|at a meeting
i: подхожу, подходишь; Она подошла к нам|She came up to us
деревья; много деревьев|trees; many trees
в нашем саду|in our garden
чуть видно; Он чуть не упал|barely visible; He nearly fell
Я не боюсь|I am not afraid
заниматься языками|to study languages
папа римский|the Pope (in Rome)
Им нужна помощь|They need help
в прошлом году|last year
Идите прямо!|Go straight on!
лучший друг; Всего лучшего!|best friend; All the best!
мастер своего дела|an expert at one’s job
секретарь директора|director’s secretary
стены дома|walls of a house
Оказалось, что он уже вернулся|It turned out that he had already returned
его сыновья; пять сыновей|his sons; five sons
мой братья; пять братьев|my brothers; five brothers
Зачем он пришёл?|Why has he come?
Они играют в футбол|They are playing football
у нас в институте|at our institute
пятый автобус|No. 5 bus
Он приедет раньше нас|He will arrive before us
В саду было тихо|It was quiet in the garden
чёрный хлеб|black bread
Пётр Великий|Peter the Great
Завтра будет собрание|There will be a meeting tomorrow
широкие улицы|wide streets
мало книг|few books
Наконец она узнала правду|In the end she learned the truth
плечи|shoulders
Разве он здесь?|Is he really here?
Разве вы не знаете?|Surely you know?
в снегу|in the snow
в будущем году|next year
с лёгким сердцем|with a light heart
Трудно её найти|It is difficult to find her
на русском языке|in Russian
Приходите к нам|Come and see us; Я пришёл первым|I arrived first
русская песня|Russian song
Он был здесь недавно|He was here recently
Советский Союз|Soviet Union
до некоторой степени|to a certain extent
Продолжайте!|Go on!
член клуба|club member
Я занят, поэтому не приду|I’m busy so I won’t come
Никто не заметит|No one will notice
В квартире три комнаты|The flat has three rooms
Его отец умеет говорить на пяти языках|His father can speak five languages. p: сумею, сумеешь
солнечный свет; вокруг света|sunlight; round the world
смотреть назад; два года (тому) назад|to look back; two years ago
три школьника|three schoolboys
Мы идём домой|We are going home
иметь право; изучать право|to have the right; to study law
сильные руки|strong hands
мужчина средних лет|a middle-aged man
Читайте дальше!|Read on!
трудная задача|difficult task
я бегу, ты бежишь, они бегут|I run, you run, they run
сильные ветры|strong winds
Он будет помогать нам|He will be helping us; Я тебе помогу; Ты поможешь мне|I shall help you; You will help me
словно он уже был там|as if he had already been there 
дорогие книги|expensive books
история России|history of Russia
я молчу, ты молчишь|I say nothing, you say nothing; p: замолчу, замолчишь
сидеть на солнце|nothing to sit in the sun
Павел дома?|Is Pavel at home?
открытое море; моря|the open sea; seas
У него огромная квартира|He has an enormous flat
ученики школы No. 5|the pupils of school no. 5
чувство юмора|sense of humour
я пою, ты поёшь|I sing, you sing; p спою, споёшь
борьба за власть|struggle for power
выступить с речью|to make a speech; русская речь|Russian speech (=spoken Russian)
Я еду на машине, а ты едешь на автобусе|I’m going by car, and you’re going by bus; я поеду, ты поедешь|I’ll go, you’ll go
много хлеба|a lot of bread
уличное движение|son to the park traffic
праздник Первого мая|May Day holiday
обращать внимание на +а|to pay attention to/note
Я считаю это нужным|I consider this necessary /p сочту, сочтёшь, past счёл, сочла
считать до десяти|to count to ten
Он иногда помогает мне|He sometimes helps me
я кричу, ты кричишь|I shout, you shout; p: закричу, закричишь
Он работает на новой фабрике|He works at the new factory 
Вы успеете это сделать?|Will you have time to do this?
Это действительно так|It really is so
Где именно?|Where exactly?
общее собрание; в общем|general meeting; in general
во всяком случае|in any case
директор завода; директора|factory manager; managers
красивая девушка|beautiful girl
номера|numbers
около дома; около тысячи рублей|near the house; about 1,000 roubles
Все парни считают её красивой|All the boys think her beautiful
народное хозяйство|national economy
вокруг света|around the world
русская душа; от всей Души|Russian soul; with all one’s heart
в четвёртом номере журнала|in the fourth number of the journal
шесть учеников|six pupils
Я подниму руку; Ты поднимешь этот вопрос?|I shall raise my hand; Will you raise this question?
с первого взгляда|at first sight
шесть инженеров|six engineers
Иван, а также Борис|Ivan and also Boris
тяжёлая промышленность|heavy industry
два цветка; красивые цветы|two flowers; nice flowers
i Я беру книгу, а ты берёшь газету|I take a book, and you take a paper; p Я возьму такси; Ты возьмёшь эту книгу?|I shall take a taxi; Will you take this book?
Конца ещё не видно|The end is not yet in sight
в воздухе|in the air
Мы давно здесь|We have been here a long time
p Я забуду его, ты тоже забудешь о нём|I’ll forget him, you’ll forget about him too
из-за дождя|because of the rain
По опыту знаю|I know by experience
Как вас зовут? Он зовёт на помощь|What is your name? He is calling for help; p позову, позовёшь
работать на стройке|to work on a building site
жёны|wives
бутылка молока|bottle of milk
i: ставлю, ставишь; Я поставлю машину здесь; Он поставит бутылку на стол|I will park my car here; He will put the bottle on the table
Однако, он забыл|However, he forgot
Он стоит на углу|He is standing at the corner
писать на красной бумаге|to write on red paper
Президент примет его завтра; Я приму меры|The president will see him tomorrow; I shall take measures
длинная улица|long street
занятия в университете|university studies
чистые руки|clean hands
я сажусь, ты садишься|I sit down, you sit down; я сяду, ты сядешь; Сядем на автобус|I’ll sit down, you’ll sit down; Let’s take a bus
Я бываю здесь часто|I come here often
шестая квартира|flat no. 6
военное время; военные|wartime; soldiers
i: встаю, встаёшь; p: Я встану в восемь часов; Ты встанешь в семь|I shall get up at eight; You’ll get up at seven
олимпийские игры|Olympic Games
член литературного кружка|member of a literary group
хозяева своей страны|masters of one’s own country
Нет никакого сомнения; Он ни к какому выводу не пришёл|There is no doubt at all; He came to no conclusion
дядя Ваня|Uncle Vanya
живой ум|lively mind
много деревень; жить в деревне|many villages; to live in the countryside
образ жизни; таким образом; образ правления|way of life; thus; form of government
Всё в порядке|Everything is alright
стать строителем|to become a construction worker
иметь успех; успехи|to be successful; progress/success
i: приношу, приносишь; Я принесу хлеб; Он принёс книгу|I shall bring the bread; He brought the book
слишком долго|too long
Доброе утро!|Good morning!
прежде всего|first of all
рассказы Чехова|Chekhov’s short stories
десять семей|ten families
в восемь часов утра|at eight o’clock in the morning
концентрационные лагеря|concentration camps
Я не знаком с ним; мои знакомые|I don’t know him; my acquaintances
Британская армия|the British Army
нос к носу; Зима на носу|face to face (nose to nose); Winter is coming (is on the nose)
Садитесь, пожалуйста|Please sit down
Он собирается уехать|He is about to leave
начать сначала|to begin from the beginning
западная техника|Western technology
много денег|a lot of money
сделать доклад|to make a report
оба доклада; обеими руками|both reports; with both hands
седьмое нёбо|seventh heaven
Он пришёл очень поздно|Не came very late
i попадать в цель to hit the target; Он не попадёт в цель; Как мне попасть на Красную площадь?|He won’t hit the target; How do I get to Red Square?
встреча со студентами|a meeting with the students
возможность поехать в Россию|a chance to go to Russia
министерство культуры|ministry of culture
i Я следую за ней; Вам следует помочь им|I am following her; You ought to help them; p последую, последуешь
футбольная команда|football team
Ну вот ...; Ну хорошо|Well, then ...; All right then
стоять в очереди|stand in a queue/wait in line
личный опыт|personal experience
средняя школа|secondary school
Он рос быстро; Он растёт|He grew quickly; He is growing
в колхозе|on a collective farm
по этой причине; причина войны|for that reason; reason for/cause of war
Ребята играют во дворе|The children play in the courtyard
Девочке пять лет|The little girl is five years old
Многие так думают|Many (people) think so
новые организации|new organizations
молодые мамы|young mothers
Поезд остановился на станции|The train stopped at the station
Я пойду туда завтра|I shall go there tomorrow
не так уж много|not so very many
Совершенно правильно|Absolutely right
Он спокойно взял все доллары|He calmly took all the dollars
Мне хотелось бы поговорить с ней|I should like to talk to her; p захочется
Всё-таки он не прав|Nevertheless he is wrong
Я знаю больше, чем вы|I know more than you do
Говорят, будто он ушёл|They claim he has left
по моему мнению|in my opinion
Я здесь впервые|I haven’t been here before
Можно взять любую книгу|You may take any book
Говорите медленно, пожалуйста|Please speak slowly
помогать друг другу|to help each other
Ей приходится молчать; Нам приходилось помогать им|She has to keep quiet; We had to help them; Нам пришлось уйти; Вам придётся идти к начальнику|We had to leave; You’ll have to go to the boss
в начале года|at the beginning of the year
Они похожи друг на друга|They are alike
читальный зал|reading room
Вы держите молоко в холодном месте?|Do you keep the milk in a cold place?
мелкое предприятие|a small business
спортивный зал|gymnasium/sports hall
весёлое настроение|cheerful mood
Да здравствуют мир и дружба!|Long live peace and friendship!
Здравствуй, Наташа|Hello, Natasha
шаг вперёд|a step forward
зелёная книга|a green book
небеса|the heavens
Я встречу вас на вокзале; Ты встретишь Новый год с нами?|I shall meet you at the station; Will you see the New Year in with us?
его отношение к вам; англо-русские отношения|his attitude to you; Anglo-Russian relations
много бабушек|many grandmothers
детский сад|kindergarten
p: Я остановлюсь перед домом; Он не остановится|I shall stop in front of the house; He will not stop
ответ на вопрос|answer to a question
в восьми школах|in eight schools
писать на доске|to write on the board
Скоро появится его жена|His wife will soon appear
восемь недель|eight weeks
Он работает на заводе |Не works in a factory
форма правления|form of government
Он является директором|He is the director
Все его вещи в этом чемодане|All his things are in this suitcase
герой войны|war hero
кроме меня; кроме того|except me; moreover/in addition
Я поднимусь на третий этаж; Они поднимутся на гору|I shall climb to the 3rd floor; They will climb the hill
дворец съездов|palace of congresses
точно в час|at one o’clock precisely
на полном ходу; ход событий|at full speed; course of events
Всё равно; Не всё ли равно?|It’s all the same; What difference does it make?
сделать шаг вперёд|to take a step forward
клуб художников|artist’s club
крупные промышленные центры|large industrial centres
Ты вспомнишь о ней?|Will you remember her?
Суздаль - город небольшой|Suzdal' is not a large town
художественная литература|belles-lettres, fiction (artistic literature)
Кто-то вошёл|Someone came in
Она нам нравится|We like her; p: понравлюсь, понравишься
школьные годы|school years
глава государства|head of state
американская армия|American army
Мы строим новую жизнь|We are building a new life
на восьмом съезде партии|at the eighth party congress
Денег осталось совсем немного|There is very little money left
сделать паузу|to pause
Она показывала ему свою квартиру|She was showing him her flat; Я покажу тебе дорогу|I shall show you the way
Иван живёт далеко от нас|Ivan lives far from us
Они выпили и затем продолжали разговор|They had a drink and then continued their talk
новые здания|new buildings
однажды вечером|one evening
Птицы летят на юг|The birds are flying south.
на самолёте|by plane
семь новых зданий; с семью друзьями|seven new buildings; with seven friends
шофёр такси|taxi driver
больше двухсот|more than two hundred
известные учёные|well-known scholars
Он ответил правильно|He answered correctly
принять решение|to take a decision
Он приедет вечером|He will come in the evening
Вы готовы?|Are you ready?
Она старалась открыть дверь|She was trying to open the door
Есть хорошие книги, «Война и мир», например|There are good books, “War and Peace”, for example
простые люди|ordinary people
произведения Толстого|Tolstoi’s works
Я учу новые русские слова|I am learning new Russian words
Он учит её русскому языку|He is teaching her Russian; p научу, научишь
иными словами; тот или иной|in other words; one or other
результаты нашей работы|results of our work
доктора|doctors
Он спросил, что случилось|He asked what happened
Никто не называл её красивой|No-one called her beautiful p назову, назовёшь
важные люди|important people
знания русского языка|knowledge of Russian
Она не улыбнётся|She will not smile
Он плохо знает английский язык|He doesn’t know English well
Он научился говорить по-русски|He learned to speak Russian
p Я открою дверь; Ты откроешь окно|I shall open the door; You will open the window
i: Она остаётся на ночь; Оставалось пять минут|She is staying the night; There were five minutes left; p: Я останусь здесь|I shall stay here
общественные науки|social sciences
из камня; много камней|made of stone; many stones
против войны; против школы|against war; opposite the school
общественное развитие|social development
Боже мой!|My goodness!
развитие общества|development of society
-Как дела? -Ничего; -Простите -Ничего|- How are things? - All right; - I’m sorry - It doesn’t matter
хорошие условия|good conditions
Дамы и господа! Это господин Смит|Ladies and Gentlemen! This is Mr Smith
много солдат|many soldiers
Октябрьская революция|the October Revolution
Занятия начинаются на следующей неделе|Classes begin next week; Собрание скоро начнётся|The meeting will soon begin
g pl областей
g чего-то
g pl властей; власти authorities
nom pl судьбы, g pl судеб
принять меры to take measures
nom pl ряды; pr в ряду: row, line; pr в ряде: series
i нахожусь, находишься; p: найдусь, найдёшься; past нашёлся, нашлась
i: гляжу, глядишь; p: погляжу, поглядишь
nom pl века; в прошлом веке last century
общественное мнение public opinion
интерес к языкам interest in languages
с целью +g with the object of
g sg огня; nom pl. огни
закон природы law of nature
трудящиеся массы the working masses
pr sg бою, nom pl бой, g pl боёв
g sg луча, nom pl лучи, g pl лучей
nom pl волны, g pl волн, d pl волнам
(nom pl листья, g pl листьев) leaf (of plant); (nom pl листы, g pl листов) sheet (of paper); g sg листа
Заходи хоть на минуту Drop in if only for a moment
g sg ребёнка; nom pl дети, g pl детей
отделение связи post office; в связи с +inst in connection with; торговые связи trade links
i: верю, веришь
двое мужчин two men
g чего-нибудь
p: представлю, представишь; представить себе to imagine
i: ищу, ищешь
i служу, служишь/p послужу, послужишь; послужить примером to serve as an example
i: ем, ешь, ест, едим, едите, едят, past ел, ела; p съем, съешь, съест, съедим, съедите, съедят, past съел, съела
жизнь рабочего life of a worker; рабочий класс working class
партийные работники party workers
g sg чёрта, nom pl черти, g pl чертей
i: требую, требуешь; p потребую
g sg корабля
рабочий класс working class
nom pl числа, g pl чисел
на базе +g on the basis of
g sg пальца
a sg реку, g sg реки, nom pl реки, d pl рекам
выпивать i/пить i; i: пью, пьёшь, past пил, пила, пило; p: выпью, выпьешь
a sg гору, g sg горы, nom pl горы, g pl гор, d pl горам; в гору uphill
производство машин car production
национальное меньшинство ethnic minority
Откуда он знает? How does he know?
p: брошу, бросишь
i: смеюсь, смеёшься
i: борюсь, борешься; за +a for
nom pl смерти, g pl смертей
g pl статей
nom pl счета; счёты abacus
сельское хозяйство agriculture
транспортные средства means of transport
nom pl скорости, g pl скоростей
nom pl чай, g pl чаёв
состоит
g pl точек; точка зрения point of view
стоит; Сколько это стоит? How much is this?
g sg ума
существую, существуешь
g sg врага
no pl
i: привожу, приводишь; p: приведу, приведёшь, past привёл, привела
g pl трубок
f сня, n сие, nom pl сии; сего месяца of this month; до сих пор up till now
g sg рубля
прав -а -о -ы (short forms) Она права She’s right
в течение +g during, in the course of
no pl
nom pl мужья, g pl мужей, d pl мужьям
i: происхожу, происходишь; p: произойдёт, past произошло
приложить все усилия to make every effort
i: бью, бьёшь, p: бить/побить; побью, побьёшь
g sg американца
g sg корня, nom pl корни, g pl корней
g sg немца
p: взгляну, взглянешь
nom pl стёкла, g pl стёкол, d pl стёклам; двойные стёкла double glazing
pr sg в краю, nom pl края, g pl краёв
g sg мужика
pr sg о степи, в степи; nom pl степи, g pl степей
nom pl цвета; в цвету in blossom
short forms счастлив, счастлива
pr sg в кругу, nom pl круги
важные моменты ситуации important features of the situation
pr sg в строю
g, d, pr sg дочери, inst sg дочерью, nom pl дочери, g pl дочерей, d pl дочерям, inst pl дочерьми, pr pl дочерях
использую
i: передаю, передаёшь; p: передам -дашь -даст -дадим -дадите -дадут, f past передала
g sg десятка
pr sg о крови, в крови; g pl кровей
i: отдаю, отдаёшь; p: отдам, отдашь, отдаст, отдадим, отдадите, отдадут; f past отдала
i: Времени не хватает There isn’t enough time; p: хватит; Времени хватит There will be enough time
выступать с речью to make a speech; p: выступлю, выступишь
p: займу, займёшь, past занял, заняла, заняло
nom pl фронты, g pl фронтов
nom pl глубины
пройти мимо дома to walk past the house
g pl сотен
inst of тот; тем лучше so much the better
nom pl вёсны, g pl вёсен, d pl вёснам
i: действую, действуешь
(pr sg на полу, nom pl полы) floor; (nom pl полы, g pl полов) sex
пять процентов 5 per cent; проценты interest
на родине in one’s homeland
nom pl зубы, g pl зубов
тем не менее none the less
p: прощу, простишь; Простате! Excuse mе
i вязать or связывать; p свяжу, свяжешь
g sg песка
g sg уровня
Ладно, пусть будет по-твоему All right, have it your own way
nom pl сёла; на селе in the country
p: вызову, вызовешь
Где остальные? Where are the others?
g sg семени, nom pl семена, g pl семян, d pl семенам
данные data
вовсе не not at all
часы приёма consulting hours
и прочее (abbr и пр. or и проч.) etcetera; между прочим by the way
Вон отсюда! Get out! вон там over there
партийное руководство party leadership
i: удаётся; Ему всё удаётся He’s successful at everything; p: удастся, past удалось; Ей удалось найти место She managed to find a seat
nom pl крестьяне, g pl крестьян, d pl крестьянам
g sg стиха; стихи verses, poetry
p: убью, убьёшь
едва (ли) не nearly, almost
Неужели он не знает? Does he really not know?
g pl степеней
sg войско
что-то вроде песка something like sand
i: пользуюсь, пользуешься; p воспользуюсь
p: явлюсь, явишься
i: пеку, печёшь, пекут; past пёк, пекла
pr sg о печи, в печи; g pl печей
i: казаться or показываться; Кажется, всё хорошо|It seems all is fine; покажусь, покажешься
nom pl главы
i: плачу, плачешь; p заплачу, заплачешь
g sg церкви, inst sg церковью, nom pl церкви, g pl церквей, d pl церквам
g pl часов
pr sg о чести, в чести, g pl честей
no pl
на совещании at a meeting
nom pl слёзы, g pl слёз, d pl слезам; слёзы радости tears of joy
nom pl донья, g pl доньев; на дне моря at the bottom of the sea
пасть: паду, падёшь; past пал, пала/упасть: упаду, упадёшь; past упал упала
i заявляю, заявляешь; p: заявлю, заявишь
nom pl колени, g pl коленей; колен in set phrases: встать с колен to get up from one’s knees
p: сниму, снимешь, f past сняла
nom pl высоты
nom pl острова
i: отношусь, относишься; p отнесусь, отнесёшься, past отнёсся, отнеслась
i перестаю, перестаёшь; p перестану, перестанешь
столь важно so important
мирный договор peace treaty
социальное положение social status
nom pl волосы, g pl волос, d pl волосам
g, d, pr sg дитяти; inst дитятею; nom pl дети, g pl детей, d pl детям, inst pl детьми, pr pl детях
p: куплю, купишь
nom pl луны
p: пущу, пустишь
g sg кулака
g pl кухонь
g sg любви; inst sg любовью, d sg/pr sg любви
g sg рисунка
nom pl слой, g pl слоев
a sg цену, nom pl цены, g pl цен, d pl ценам
g sg коня, nom pl кони, g pl коней
i: теряю, теряешь; p: потеряю, потеряешь
pr sg в роду; nom pl роды; роды childbirth
g sg господа; Господи! Oh Lord! Good Heavens!
nom pl губы, g pl губ, d pl губам
p: пошлю, пошлёшь
g pl тётей
сделать вывод to draw a conclusion
i: выполняю, выполняешь
nom pl зёрна, g pl зёрен, d pl зёрнам; кофе в зёрнах coffee beans
p: добьюсь, добьёшься
g sg старика
a sg спину, nom pl спины
сужу, судишь; судя по +d judging by
p: умру, умрёшь, past умер, умерла, умерло
большой запас слов a large vocabulary
земной шар the globe
p: предложу, предложишь
i: создаю, создаёшь; p: -ам -ашь -аст -адим -адите -адут
завишу, зависишь
g sg плода; приносить плоды to bear fruit
что касается +g as for, with regard to
p: прикажу, прикажешь
родной язык native language, mother tongue; ваши родные your relatives
i: стремлюсь, стремишься
nom pl тома
ради Бога for God’s sake
Вы меня слышите?|Can you hear me?; p: услышу, услышишь
nom pl уши, g pl ушей
гораздо лучше much better
g pl площадей
nom pl поезда
nom pl профессора
g pl солей
g sg сна
pr sg в тени, g pl теней
nom pl граждане, g pl граждан
i достаю, достаёшь; p: достану, достанешь
g sg дурака
g pl лошадей, inst pl лошадьми, pr pl лошадях
 (+1st person pl р or i inf) Давайте выпьем Let’s have a drink
pl беды ; беда в том, что ... the trouble is that...
p: закрою, закроешь
nom pl звёзды, g pl звёзд
i: провожу, проводишь; p: проведу, проведёшь, past провёл, провела
размеры proportions, dimensions
p: разрешу, разрешишь
d нечему; inst нечем; pr не о чем; Нечего делать There is nothing to do
g pl лодок
g sg сапога; g pl сапог
скорее всего most probably
в дальнейшем henceforth
либо ..., либо either..., or
смотреть телевизор to watch television
(3rd pers only) имеется, имеются
no p
nom pl следы
внешняя политика foreign policy
g sg ножа
pr sg о груди в груди, g pl грудей
g sg моряка
передовая статья leading article
p: установлю, установишь
g pl ворот
g sg дворца
длиной в два метра two metres long
за +inst to watch over
p: получится
p: соглашусь, согласишься
принимать участие в +pr to take part in
Нам было весело We enjoyed ourselves
постоянный адрес permanent address
отдать приказ to issue an order
(nom pl тоны, g pl тонов) tone, musical tone; (nom pl тона, g pl тонов) colour tone, tint
g pl книжек; записная книжка notebook
pr sg о пыли, в пыли
светлая комната light room
серый волк grey wolf
оказать влияние на +а to influence s.o. or sth
p: помолчу, помолчишь
атомная электростанция atomic power station
за границей abroad
no pl; в защиту кого-нибудь in defence of s.o.
g sg куска; кусок сахара sugar lump
Молчание - знак согласия Silence gives consent
пара сапог a pair of boots
g sg платка; носовой платок handkerchief
практический опыт practical experience
в пределах +g within
g pl стенок; стенки трубки sides of a tube
живое существо living creature
нарушить тишину to break the silence
товары широкого потребления consumer goods
вершина горы mountain peak
произвести взрыв to cause an explosion
Он не виноват It’s not his fault
p вырасту, вырастешь, past вырос, выросла
гражданская война civil war
государственный деятель statesman
g sg дождя; под дождём in the rain
Его невозможно найти Не can’t be found
р also по-
i: позволяю, позволяешь; p: позволю, позволишь
nom pl роли, g pl ролей
nom pl сёстры, g pl сестёр, d pl сёстрам, inst pl сёстрами, pr pl сёстрах
жить в столице to live in the capital
стройная фигура shapely figure
g sg царя, inst sg царём
бедные люди poor people
верхняя полка upper berth
вслед за ним after him
внести изменения в +a to make changes in
ношу, носишь; indet of нести i
в особенности in particular
f рада, pl рады
Погода резко изменилась There was a sharp change in the weather
g sg звонка
no pl; В этом нет необходимости It is not essential
no pl
свобода печати freedom of the press
к/для for; по поводу +g concerning, apropos of
Он постоянно недоволен He is always dissatisfied
i: разумеется; под этим разумеется this implies; само собой разумеется it goes without saying
стакан чаю a glass of tea
точный перевод exact translation
p: уеду, уедешь
широко улыбаться to smile broadly
возможные решения possible solutions
no pl; изучение природы study of nature
i: Благодарю вас I thank you
блестящий ум brilliant mind
nom pl веса; вес пакета weight of a packet
g sg врача; Она любит врачей She likes doctors
крик восторга cry of joy
p: обеспечу, обеспечишь
g sg рта; pr sg во рту, о рте, nom pl рты, g pl ртов
соседняя комната next room
p: докажу, докажешь
Выпьем за её здоровье! Let’s drink to her health!
p: Извините! I’m sorry!
g pl ошибок; по ошибке by mistake
Он тотчас уехал Не left at once
вагон-ресторан restaurant car
горю, горишь; Горел свет There was a light on
далёкий город distant town
дипломатические каналы diplomatic channels
разговорная практика conversation practice
к сожалению unfortunately
укрепление обороны strengthening of defence
pr sg в быту; служба быта consumer services
g sg недостатка
i: подаю, подаёшь; p: подам, подашь, подаст, подадим, подадите, подадут, past подал, подала, подало; подать пример to set an example
в поисках (+g) in search of
pr sg в порту, о порте; nom pl порты, g pl портов
назначить свидание to arrange a meeting; до свидания goodbye
провести черту to draw a line
p: вздохну, вздохнёшь
g pl записок; послать записку to send a note
nom pl озёра, g pl озёр
организую, организуешь; i in past организовывать
классовое сознание class consciousness 
пять градусов тепла five degrees above zero
космическое пространство outer space
i: составляю, составляешь; p: составлю, составишь;
i: стреляю, стреляешь
вдоль реки along the river
p: встречусь, встретишься
продукты produce, provisions, food
через две секунды two seconds later
братские страны fraternal countries
i дохожу, доходишь; p: дойду, дойдёшь, past дошёл, дошла
i захожу, заходишь; p: зайду, зайдёшь; past зашёл, зашла
могучая армия powerful army
мотор автомобиля car engine
борьба за независимость independence struggle
g sg бойца
Мне его жалко I’m sorry for him
no g pl
туда и обратно there and back
p: откажусь, откажешься
g sg полка, pr sg в полку
g pl попыток
g sg угля, nom pl угли/уголья, g pl углей/угольев
a sg щёку, g sg щеки, nom pl щёки, g pl щёк, d pl щекам
pr sg в дыму, nom pl дымы
nom pl красоты
i: слежу, следишь
p: схвачу, схватишь; хватать i/схватывать i
nom pl травы
g pl улыбок
Дом далеко от центра, зато метро рядом The house is far from the centre, but (on the other hand) the metro is nearby
g sg лба, pr sg на лбу
nom pl учителя
i: воюю, воюешь
g pl юношей
из-под стола from under the table; бутылка из-под молока milk bottle
i: ложусь, ложишься; p: лягу, ляжешь, лягут, past лёг, легла, imperative ляг(те)!
i пробую, пробуешь; p: попробую, попробуешь
nom pl стулья, g pl стульев
pr sg о цепи, на цепи, nom pl цепи, g pl цепей
p: обращусь, обратишься
g sg октября
i: Чем отличается университет от института? What’s the difference between a university and an institute?
i: повторяю, повторяешь
pr sg в долгу, nom pl долги
a sg зиму, g sg зимы, nom pl зимы
i знакомлюсь, знакомишься; p: познакомлюсь, познакомишься
nom pl чудеса, g pl чудес, d pl чудесам
pr sg на боку, nom pl бока
i ввожу, вводишь; p: введу, введёшь, past ввёл, ввела
i: держусь, держишься
i жалею, жалеешь; p пожалею, пожалеешь
Итак, теперь всё ясно So now everything is clear
i: надеюсь, надеешься
nom pl облака, g pl облаков
i отхожу, отходишь; p: отойду, отойдёшь, past отошёл, отошла; отойти от окна to move away from the window
p: рожусь, родишься, past родился, родилась
no pl
i: вишу, висишь
g sg образца
i: принадлежу, принадлежишь
g sg суда
nom pl адреса
no 1st person sg, p: победишь
short forms: уверен, уверена
обладать хорошим умом to have a good brain
with f nouns полторы; g, d, inst, pr полутора; полтора года 1.5 years
Он считается гением Не is considered a genius; С этим можно не считаться This can be ignored
i: участвую, участвуешь
p: брошусь, бросишься
p разовьюсь, разовьёшься, past развился, развилась
i тяну, тянешь
g sg января
no pl
частная собственность private property; собственность на землю ownership of land
no 1st pers sg, p: убедишься
nom pl кольца, g pl колец, d pl кольцам
g sg мешка
pr sg на мосту, nom pl мосты
g sg снимка
i: тороплюсь, торопишься
nom pl вести, g pl вестей
i: говорится; как говорится as they say
g, d, pr девяти, inst девятью
no pl
p: погожу, погодишь; Погодите! Wait a moment!
short forms: пьян, пьяна, пьяно, пьяны
nom pl толпы
i: ударять/бить; i ударяю
short forms зол m, зла f
назначение инструмента purpose of a tool; использовать что-нибудь по назначению to use sth for its proper purpose
pr sg в пару, nom pl пары
i: Вы читали эту книгу?|Have you read this book? /p прочту, прочтёшь, past прочёл, прочла; p also прочитать
собственно говоря strictly speaking
i: готовлю, готовишь
великие державы the Great Powers
i: заставляю, заставляешь; p: заставлю, заставишь; Он заставил нас выучить все слова Не forced us to learn all the words
nom pl колёса, g pl колёс
i: лечу, летишь; det verb of motion; p: полечу, полетишь
only nom and а; нечто другое something else
no p
g pl пропастей
p: соберу, соберёшь, past собрал, собрала, собрало
g pl хозяек
f чья, n чьё, pl чьи; Это чья книга? Whose book is this?
no pl
nom pl доли, g pl долей
подвести итоги to sum up
i признаю, признаёшь
g sg среды, nom pl среды, a sg среду, d pl средам
(indecl)
g pl дедушек
в действительности in reality, in actual fact
на заседании at a meeting
g sg ключа
g pl кресел
i: оставляю, оставляешь; p оставлю, оставишь
p: остановлю, остановишь
p: отмечу, отметишь
i: поступать в университет to enter а university; p поступлю, поступишь
по сравнению с +inst compared with
Как вам не стыдно? You ought to be ashamed
g sg танца
Добро пожаловать! Welcome!
p: заключу, заключишь
Я был там когда-то I was there once
i: перехожу, переходишь; p: перейду, перейдёшь, past перешёл, перешла
p: привыкну, привыкнешь, past привык, привыкла
p: пришлю, пришлёшь
g pl спичек
внешняя торговля foreign trade; торговля оружием arms trade
p: захвачу, захватишь
конкретный пример specific example
i отправляю; p отправлю, отправишь
nom pl трубы
nom pl тюрьмы, g pl тюрем
p: past погиб, погибла
p: прибуду, прибудешь, past прибыл, прибыла, прибыло
p состоится; no i
g pl капель
i: содержит
цветной телевизор colour television
nom pl шары; земной шар the globe
i: вру, врёшь
p: past исчез, исчезла
i: Куда ведёт эта дорога? Я веду сына в парк|Where does this road lead? I am taking my son to the park; p: поведу, поведёшь, past повёл, повела
Он стоит за домом|He is standing behind the house; p: постою, постоишь
g sg рукава, nom pl рукава
Соединённые Штаты Америки (США) United States of America
i: тружусь, трудишься
i: шумлю, шумишь
i: езжу, ездишь; p: по-/съ-
i: лезу, лезешь, past лез, лезла; p полезу, полезешь; past полез, полезла
p образую, образуешь
g pl печек
i: шучу, шутишь
g pl шуток
i: гуляю, гуляешь; p погуляю
g pl зверей
i: звучит; Это звучит странно That sounds strange
i командую, командуешь
i: курю, куришь; p: по-/за-
Он непременно придёт He’ll definitely come
p: образуется
nom pl полосы, g pl полос, d pl полосам
собор святого Павла St. Paul’s Cathedral
g pl суток; трое суток three days and nights
p: убегу, убежишь, убегут
g pl шапок
no pl except in меньшее из двух зол lesser of two evils
nom pl крыльца, g pl крылец, d pl крыльцам
nom pl соседи, g pl соседей
в сущности in essence
nom pl англичане, g pl англичан
на востоке in the east
g sg карандаша
(nom pl корпуса) corps; building; (nom pl корпусы) body, frame
g pl красок
p: похожу, походишь
no p
nom pl пояса
p: укажу, укажешь
Вряд ли он придёт He’s unlikely to come
Очень жаль, что вас не было What a pity you weren’t there
i изменяю; p: изменю, изменишь
g pl минуток; Одну минутку Just a moment
Мне некогда I haven’t time; Некогда здесь было озеро There was once a lake here
pr sg на посту, nom pl посты
на расстоянии трёх километров three kilometres away
often pl; У меня нет сведений об этом I have no information about that
на севере in the north
i: сержусь, сердишься; p рассержусь, рассердишься
p защищу, защитишь
на кафедре русского языка in the Russian department
no pl; виды спорта sports
p: выпущу, выпустишь
i: дышу, дышишь; дышать свежим воздухом to breathe fresh air
i: кладу, кладёшь, past клал, клала; p: положу, положишь
p: опущу, опустишь
спустя три дня three days later
строительная площадка building site
i устаю, устаёшь; p устану, устанешь
i: берусь; берёшься, past брался, бралась; p: возьмусь, возьмёшься, past взялся, взялась
nom pl величины
nom pl зеркала, g pl зеркал, d pl зеркалам
nom pl крылья, g pl крыльев
i: определяю, определяешь
g pl платьев
p: разберусь, разберёшься, past разобрался, разобралась
g pl пушек
экзамен по русскому языку Russian exam
i выгляжу, выглядишь; Она выглядит хорошо She looks well
i готовлюсь, готовишься
i добавляю; p добавлю, добавишь
i: дрожу, дрожишь
i объявляю; p объявлю, объявишь
p: покрою, покроешь
g sg попа
g pl привычек
nom pl строки, d pl строкам
i тянется; p потянусь, потянешься
a sg бороду, nom pl бороды, g pl бород, d pl бородам
коротко говоря in short
охота на лис fox hunting
ровно в десять at ten o’clock precisely
g sg быка
p: выдержу, выдержишь
p: достигнуть or достичь; past достиг, достигла
Она, мол, не знает She said she doesn’t know
g sg пламени, no pl
p: протяну, протянешь
nom pl сторожа
p ступлю, ступишь
g pl бутылок
i: волнуюсь, волнуешься; Не волнуйтесь Don’t worry; p: вз-/за-
на западе in the west
i направляю; p: направлю, направишь
p разобью, разобьёшь
i: смею, смеешь
g sg ствола
g sg фонаря
сорок градусов мороза forty degrees below zero
p: допущу, допустишь
g pl сказок
i схожу, сходишь; p: сойду, сойдёшь, past сошёл, сошла; сойти с ума to go mad
g pl старушек
велю, велишь; p also по-
гоню, гонишь, past гнал, гнала, гнало
p: завоюю, завоюешь
nom pl избы
g sg льда, pr sg на льду
g pl новостей
i: пахнет
g pl повестей
i торчу, торчишь
p выражу, выразишь
i посвящу, посвятишь
g sg пустяка
nom pl пятна, g pl пятен
i Мы располагаем большими деньгами We have plenty of money available; p расположу, расположишь
как вам угодно as you wish; когда вам угодно whenever you like
в частности in particular
двое детей two children
g pl девчонок
Европейский Союз European Union
меняю, меняешь
nom pl нужды
p подпишу, подпишешь
избирательный участок electoral district
бригада рабочих team of workers
командиры армии army commanders
i бьюсь, бьёшься
зря деньги тратить to waste money
i исхожу, исходишь
i отправляюсь; p отправлюсь, отправишься
i: чувствую, чувствуешь; p почувствую
признаки жизни signs of life
i светится
g pl сетей
p спасу, спасёшь, past спас, спасла
Дело заключается в следующем The matter is as follows
g pl мальчишек
p доложу, доложишь
p займусь, займёшься, past занялся, занялась
i изменяюсь; p изменюсь, изменишься; Всё изменилось Everything has changed
на конференции at a conference
g sg куста
pr sg в мозгу, nom pl мозги
p обниму, обнимешь, past обнял, обняла, обняло
p превращусь, превратишься
шёпотом in a whisper
заместитель директора deputy director
g pl клеток
Неизвестно, кто её отец No-one knows who her father is
не рассчитать to miscalculate, misjudge
f такова, n таково, pl таковы; Такова жизнь Such is life
усы moustache
p арестую
i берегу, бережёшь, берегут, past берёг, берегла
p вступлю, вступишь; вступить в политическую партию to join a political party
g sg греха
g pl дочек
Я хочу вам кое-что сказать I want to tell you something
оттого что because
p: сплавать to swim there and back
g pl поездок
nom pl ружья, g pl ружей
nom pl вина
p past возник, возникла
i жалуюсь, жалуешься
i заменяю; p заменю, заменишь
Молодцы, ребята! Well done, lads!
p надену, наденешь
i объясняю
i: произвожу, производишь; p произведу, произведёшь, past произвёл, произвела
i стучу, стучишь
гарантирую
g sg знамени; nom pl знамёна
на концерте at a concert
g sg костра
насколько мне известно as far as I know
nom pl перья
p приобрету, приобретёшь, past приобрёл, приобрела
nom pl свечи, g pl свечей
на складе in the warehouse
short forms: согласен, согласна, согласно, согласны; Вы согласны? Do you agree?
i способствую
p справлюсь, справишься
i танцую, танцуешь
i тащу, тащишь
i беседую, беседуешь
i выдаю, выдаёшь; p выдам, выдашь, выдаст, выдадим, выдадите, выдадут
выдающиеся учёные eminent scholars
i гужу, гудишь
g pl дорожек
i доставляю; p доставлю, доставишь
g sg креста
g sg ноября
i привожу, привозишь; p привезу, привезёшь, past привёз, привезла
i прячу, прячешь; p спрячу, спрячешь
сегодняшняя газета today’s paper
глупости nonsense
деловые люди businesspeople
p загляну, заглянешь
ни в коем случае certainly not
p откроется; Музей откроется в десять The museum will open at ten
в отличие от +g as distinct from
g pl перестроек
p раскрою, раскроешь
i соответствует
g sg хвоста
на вокзале at the station
i довожу, доводишь; p доведу, доведёшь, past довёл, довела
i обращать внимание на +а to note, take note of; p: обращу, обратишь; обратить внимание на +а to note sth
i плачу, платишь
p посажу, посадишь
i предстоит; Ему предстоят трудности Не faces difficulties
на рынке in the market
g sg столба
трое детей three children
i вношу, вносишь; p внесу, внесёшь, past внёс, внесла
i грожу, грозишь; p: при-/по-
и так далее (и т.д.) and so on, etc
short forms: m доволен, f довольна, pl довольны; Я довольна ими I’m pleased with them
в зависимости от +g depending on
Вы видели кого-нибудь? Did you see anyone?
i оказывать помощь to give assistance; p окажу, окажешь; оказать влияние на +a to exert an influence on
g pl подушек
система правления system of government
i расходимся, past разошлись; p разойдёмся, past разошлись
g pl рубашек
nom pl скалы
i терплю, терпишь
i управляю
g sg февраля
(or гм)
p выберу, выберешь
g sg декабря
nom pl зори, g pl зорь, d pl зорям
nom pl колокола
i меняюсь; Всё меняется Everything is changing; p: об-/по-
p оглянусь, оглянешься
(nom pl ордена) medal, decoration; (nom pl ордены) order (society)
p отпущу, отпустишь
g pl очков
i перевожу, переводишь; p переведу, переведёшь, past перевёл, перевела
i применяю; p применю, применишь
p присяду, присядешь, past присел, присела
i проверяю
p уберу, уберёшь, past убрал, убрала, убрало
i гожусь, годишься
женюсь, женишься
(indecl)
обратный адрес sender’s address; в обратную сторону in the opposite direction
p перебью, перебьёшь
(f)
no pres
i слышится
i сочиняю
(f)
с толком sensibly
i хохочу, хохочешь
g pl копеек
p отниму, отнимешь, past отнял, отняла, отняло
p отступлю, отступишь
g sg раба
g pl ручек
p скрою, скроешь
i торгую
pr sg в грязи
p доберусь, доберёшься, past добрался, добралась
g pl должностей
g pl коек
g pl локтей
p надоем, надоешь (like есть), past надоел, надоела; Он ей надоел She’s bored with him
g pl окошек
p прекращу, прекратишь
Работа продолжалось The work continued
i произношу, произносишь/p произнесу, произнесёшь, past произнёс, произнесла
(indecl)
p вбегу, вбежишь, вбегут
i везу, везёшь, past вёз, везла/p повезу, повезёшь, past повёз, повезла; Нам повезло We were lucky
g pl ветвей
p вскочу, вскочишь
i вывожу, выводишь; p выведу, выведешь, past вывел, вывела
short forms занят, занята, занято, заняты; Он занят He’s busy
p запишу, запишешь
Она обязана прийти She must come
i ору, орёшь
p оценю, оценишь
g sg племени, nom pl племена
p поглощу, поглотишь
p подготовлю, подготовишь
i проводится
p сложусь, сложишься
g pl страстей
g pl тарелок
g трёхсот
no 1st pers sg, p убедишь
g sg холма
i выношу, выносишь; p вынесу, вынесешь, past вынес, вынесла
мне думается I think
в заключение in conclusion
p изучу, изучишь
i кормлю, кормишь; на- p/по- р
p одену, оденешь
g pl палок
g pl площадок; датская площадка children’s playground
p подтвержу, подтвердишь
g sg сентября
i сую, суёшь; p суну, сунешь
pr sg в тылу
g pl бумажек
nom pl валы
i дерусь, дерёшься, past дрался, дралась
nom pl звенья
p наступлю, наступишь; Наступило лето Summer came
g sg огонька
p освобожу, освободишь
Директор в отпуске The director is on holiday
g pl переговоров
g sg пиджака
плотный обед filling meal
p поддержу, поддержишь
g pl полок
Вход посторонним воспрещён Private
p: пропаду, пропадёшь, past пропал, пропала
на аэродроме at an airfield
p налью, нальёшь, past налил, налила, налило, imperative налей(те)
i направляюсь; p направлюсь, направишься
p обману, обманешь
p осную, оснуёшь
отложу, отложишь
g pl полосок
g pl пристаней
p разберу, разберёшь, past разобрал, разобрала, разобрало
скорый поезд fast train
p сосредоточить внимание на +pr to concentrate attention on sth
i удивляюсь; p удивлюсь, удивишься
f божья, n божье
nom pl вёрсты, g pl вёрст
g pl заметок
g pl кукол
i ловлю, ловишь
так называемый so-called
g pl пластинок
i плыву, плывёшь, past плыл, плыла, плыло
p подберу, подберёшь, past подобрал, подобрала, подобрало
i: целую, целуешь; p поцелую, поцелуешь
p превращу, превратишь
g pl пуль
i руковожу, руководишь
nom pl сорта; высший сорт top quality
научная фантастика science fiction
nom pl верхи
i догоняю; p догоню, догонишь, past догнал, догнала, догнало
g sg зайца
= если (also коль)
no pl
pr sg на лугу, nom pl луга
i публикую
g pl оценок
i приветствую
i применяюсь
i бормочу, бормочешь
nom pl вёдра, g pl вёдер
p вырвусь, вырвешься
p выскажу, выскажешь
g pl выставок; на выставке at an exhibition
p дождусь, дождёшься, past дождался, дождалась
g sg игрока
g sg короля
g pl лавок
i наношу, наносишь; p нанесу, нанесёшь, past нанёс, нанесла
i объясняюсь
p освобожусь, освободишься
p отзовусь, отзовёшься, past отозвался, отозвалась
p положусь, положишься
p превышу, превысишь
p приглашу, пригласишь
p пройдусь, пройдёшься, past прошёлся, прошлась
i/p
g sg топора
p трону, тронешь
pr в/на шкафу
на юге in the south
i брожу, бродишь
i волнует
pr sg в гробу, nom pl гробы
g pl девок
действующий вулкан active volcano
i исполняю
g sg кирпича
g pl ложек
i любуюсь; p полюбуюсь
g pl ниток
p отражу, отразишь
на пасху at Easter
в письменном виде in written form; письменный стол desk
no i
на почте at the post office
p призову, призовёшь, past призвал, призвала, призвало
p past проник, проникла
i светит
суть дела the heart of the matter
p удержу, удержишь
i ценю, ценишь
i выгоняю, выгоняешь; p выгоню, выгонишь
i изволю, изволишь; Извольте выйти Kindly leave
i интересует; p заинтересует
Ишь какой грязный! Look how dirty it is!
i наполняю
g pl папок
p повышу, повысишь
p понадобится; если понадобится if necessary
p приступлю, приступишь
Продолжение следует То be continued
p разбужу, разбудишь
no pl
g pl решёток
nom pl свиньи, g pl свиней, d pl свиньям
i свищу, свистишь
g pl тряпок
g sg этажа
i блещу, блестишь or блещешь
or запасный
p: засы́пать
p изберу, изберёшь, past избрал, избрала, избрало
g pl костей
p ошибусь, ошибёшься; past ошибся, ошиблась
p повешу, повесишь
p помещу, поместишь
p предупрежу, предупредишь
p проживу, проживёшь, past прожил, прожила, прожило
g пятисот, d пятистам, inst пятьюстами, pr пятистах
g pl скатертей
из соображений безопасности for security reasons
nom pl стрелы
nom pl струи, g pl струй, d pl струям
g sg узла
g pl усмешек
nom pl яблоки, g pl яблок
владею, владеешь; Она владеет пятью языками She speaks five languages
p возрасту, возрастёшь; past возрос, возросла
i гасну, гаснешь, past гас, гасла
(pl)
g sg дневника
g pl картинок
nom pl косы; (а ко́су) plait; (а косу́) scythe
g pl кошек
g pl мышей
p преодолею, преодолеешь
i продаю, продаёшь; p продам, продашь, продаст, продадим, продадите, продадут, past продал, продала, продало
вз-/из-/об- р
g pl свадеб
печатные станки printing presses
в ущерб +d to the detriment of
g pl штанов
p вынужу, вынудишь
выходной день day off
i забочусь, заботишься
i завидую, завидуешь
p закурю, закуришь
no pl
Милости просим! Welcome!
i мчусь, мчишься
i определяется
i пожимать руку +d to shake s.o.’s hand; p пожму, пожмёшь
i поздравляю; p поздравлю, поздравишь
стоять поперёк дороги to be in the way; вдоль и поперёк far and wide
p поручу, поручишь
p прижму, прижмёшь
i проявляю; проявлять инициативу to show initiative; p проявлю, проявишь
i режу, режешь; по-/на-/раз- р
g sg скота
сырое мясо raw meat
no pl
i теку, течёшь, текут; past тёк, текла
дать течь to spring a leak
p: усмехнусь, усмехнёшься
i шепчу, шепчешь
нижнее бельё underwear
p возражу, возразишь
p выпаду, выпадешь; past выпал, выпала
nom pl грозы
i доносится; p донесётся, past донёсся, донеслась
p заберу, заберёшь, past забрал, забрала, забрало
i задаю, задаёшь; задавать вопрос to ask а question; p задам, задашь, задаст, зададим, зададите, зададут, past задал, задала, задало
p задержусь, задержишься
p заложу, заложишь
g pl занавесок
p запру, запрёшь; past запер, заперла, заперло
i издаю, издаёшь; p издам, издашь, издаст; издадим, издадите, издадут, past издал, издала, издало
f какова, n каково, pl каковы; Каков он? What’s he like?
любитель музыки music lover
no pl
i ненавижу, ненавидишь
p обсужу, обсудишь
p обопрусь, обопрёшься, past опёрся, оперлась
p освещу, осветишь
= поднимать i
Было полно народа There were lots of people
Полно жаловаться Stop complaining
p попадусь, попадёшься, past попался
i преследую, преследуешь
i раздаётся; p раздастся, past раздался, раздалась
g pl рамок
p сложу, сложишь
p сорву, сорвёшь, past сорвал, сорвала, сорвало
g sg табака
nom pl баре or бары, g pl бар
g pl барышень
вдвое больше twice as much
g pl веток
g sg владельца
nom pl волки, g pl волков
p добуду, добудешь, past добыл, добыла, добыло
g sg живота
i качать головой to shake one’s head
минеральная вода mineral water
Почта недалеко The post office is not far
p опущусь, опустишься
i осуществляю; p: осуществлю, осуществишь
p помру, помрёшь; past помер, померла, померло
i предоставляю; p предоставлю, предоставишь
пропущу, пропустишь
i распространяется
g sg рубежа; g sg рубежа; за рубежом abroad
i сияю, сияешь
i советую, советуешь; p посоветую
pr sg в соку
p соображу, сообразишь
i сохраняюсь
g pl ступеней
g sg стыда
i валяюсь, валяешься
g pl верёвок
p выброшу, выбросишь
i дую, дуешь
p зажгу, зажжёшь, зажгут; past зажёг, зажгла
p застану, застанешь
i здороваюсь
g pl мелочей
i мою, моешь
p опишу, опишешь
p отре́зать, отре́жу, отре́жешь
p охвачу, охватишь
g pl плёнок
p прикрою, прикроешь
i прилагать (все) усилия к +d to make every effort to; p приложу, приложишь; прикладывать i/прилагать i
i развожу, разводишь; p разведу, разведёшь, past развёл, развела
no р
i создаётся; p создастся
i сохраняю, сохраняешь
p спущусь, спустишься
g pl сумерек
i вожу, возишь
i выделяю, выделяешь
p выеду, выедешь
p вытру, вытрешь; past вытер, вытерла
i голосую, голосуешь
nom pl дубы
i завожу, заводишь; p заведу, заведёшь, past завёл, завела
i качусь, катишься; Пот катился со лба Sweat was rolling down his forehead
i кручу, крутишь; за-/с-/по- p
nom pl овцы, g pl овец, d pl овцам
p отнесу, отнесёшь; past отнёс, отнесла
i подвожу, подводишь; подводить итоги to sum up
no p
p посещу, посетишь
pr sg в поту
p приготовлю, приготовишь
смотреть пристально на +а to stare at
на протяжении (+g) during
p рассмотрю, рассмотришь
i рву, рвёшь, past рвал, рвала, рвало
p собью, собьёшь
p Она свернула налево She turned left
i свожу, сводишь/p сведу, сведёшь, past свёл, свела
g pl скамеек
сплошь и рядом very frequently
nom pl судьи, g pl судей, d pl судьям
g pl усадеб and усадьб
g pl чашек
nom pl брёвна, g pl брёвен
i виднеется
p восстановлю, восстановишь
p вылезти or вылезть; p вылезу, вылезешь; past вылез, вылезла
i интересуюсь, интересуешься
m pl
= который/какой
g pl крышек
по- p/с- р
p напьюсь, напьёшься, past напился, напилась
i несусь, несёшься; past нёсся, неслась
i ночую, ночуешь
Объединённые Нации United Nations
g pl остановок; без остановки without stopping
на пенсии retired
pr sg в плену
= подниматься
p поём, поёшь, поест, поедим, поедите, поедят, past поел, поела
g полугода
i: несу, несёшь; past нёс, несла; p понесу, понесёшь, past понёс, понесла
p примусь, примешься; past принялся, принялась
p сожгу, сожжёшь, сожгут, past сжёг, сожгла
g pl скамей
g pl спинок
i прячусь, прячешься; p спрячусь, спрячешься
вс- р; по- р
на худой конец if the worst comes to the worst
бурый медведь brown bear
i валю, валишь; p: по- or с-
no i
g sg гриба
nom pl гуси, g pl гусей
g pl забастовок
i обхожусь, обходишься; p обойдусь, обойдёшься, past обошёлся, обошлась
p обяжу, обяжешь
p одержу, одержишь; одержать победу to be victorious
p переживу, переживёшь, past пережил, пережила, пережило
nom pl повара
ничего не поделаешь it can’t be helped
p пригожусь, пригодишься
p прогоню, прогонишь, past прогнал, прогнала, прогнало
i проявляется; p проявится
p расспрошу, расспросишь
i свидетельствует
nom pl штабы
pr sg на борту; nom pl борта; на борту on board (ship or plane)
pr sg в цехе or в цеху; nom pl цехи or цеха
g sg казака́, nom pl казаки́ (but Tolstoi’s «Каза́ки»)
g pl обработок
g sg рыбака
g pl ступенек
nom pl суда, g pl судов
теряюсь, теряешься; по- р; рас- р
p учту, учтёшь, past учёл, учла
f чья-то, n чьё-то, pl чьи-то
pr на бегу
о- or по- р
p взорву, взорвёшь, past взорвал, взорвала, взорвало
g pl внучек
p возбужу, возбудишь
i горжусь, гордишься; Мы гордимся дочкой We’re proud of our daughter
i достаётся; p достанется
i колеблюсь, колеблешься
g pl лампочек
летучая мышь bat
p накрою, накроешь; накрыть (на) стол to lay the table
g sg ноля
i отстаю, отстаёшь; p отстану, отстанешь
= папа
i повторяется
g sg подлеца
p подхвачу, подхватишь
i краснею, краснеешь
p поражу, поразишь
p предположу, предположишь
i придаю, придаёшь; придавать значение чему-нибудь to treat sth as important; p придам, придашь, придаст, придадим, придадите, придадут, past придал, придала, придало
p проберусь, проберёшься, past пробрался, пробралась
i радуюсь, радуешься; p обрадуюсь
p расстреляю
nom pl редактора
i рублю, рубишь
i сдаю, сдаёшь; p: сдам, сдашь, сдаст, сдадим, сдадите, сдадут, past сдал, сдала, сдало
p смущусь, смутишься
p спущу, спустишь
p увлеку, увлечёшь, увлекут, past увлёк, увлекла
уход за ребёнком caring for а child
g sg чудака
g pl верхушек
g, d, pr восьмидесяти, inst восемьюдесятью
p: вре́заться, вре́жусь, вре́жешься
i глажу, гладишь
g pl загадок
по- р/при- р
i наклоняюсь; p наклонюсь, наклонишься
p намечу, наметишь
p настою, настоишь
p настанет
i объединяю
g pl полотенец
Он работает здесь|He works here
g pl построек
i присутствую
i расстаюсь, расстаёшься; p расстанусь, расстанешься
i рвусь, рвёшься, past рвался, рвалась
i сею, сеешь
i соединяются
i уверяю, уверяешь
p утвержу, утвердишь
характеризую, характеризуешь; р also о-
g pl башен
p ворвусь, ворвёшься, past ворвался, ворвалась
p выберусь, выберешься
p выдвину, выдвинешь
p вылечу, вылетишь
p вырву, вырвешь
g sg гвоздя, nom pl гвозди, g pl - ей
nom pl гнёзда
g sg грузовика
p изображу, изобразишь
no pl
g pl курток
i лгу, лжёшь, лгут, past лгал, лгала, лгало
g pl марок
i машу, машешь; по- р/ махнуть р
g sg некоего
i обвиняю, обвиняешь
смотри на обороте РТО
i подчиняю
g sg получаса, nom pl получасы
i поправляю; p поправлю, поправишь
p предприму, предпримешь; f past предприняла
i прибавляю; p прибавлю, прибавишь
i разделяю; p разделю, разделишь
p рассмеюсь, рассмеёшься
p сброшу, сбросишь
g pl сволочей
Мне ничего не слышно I can’t hear anything
соединяю, соединяешь
в соответствии с +inst in accordance with
на старости лет in one’s old age
i удовлетворяю
p уступлю, уступишь
nom pl широты
p вгляжусь, вглядишься
i вижусь, видишься
p заберусь, заберёшься, past забрался, забралась
высшее учебное заведение (вуз) institution of higher education
p задержу, задержишь
p избегу, избежишь, избегут
i извиняюсь
i киплю, кипишь
g pl коробок
миную, минуешь; Опасность миновала The danger has passed
нарушить правило to break a rule
Некуда идти There is nowhere to go
Как обстоит дело? How’s it going?
p отражусь, отразишься
i охраняю
g sg очага
i переношу, переносишь; p перенесу, перенесёшь, past перенёс, перенесла
g полудня
p порву, порвёшь, f past порвала; порвать отношения с кем-нибудь to break off relations with s.o.
i: требуется; p потребуется
p привлеку, привлечёшь, привлекут, past привлёк, привлекла
p провалюсь, провалишься
В комнате пусто The room is empty
p рожу, родишь, f past родила; рож(д)ать i
товарный знак trade mark
p уложу, уложишь
nom pl чины
p: по-/шевельнуться
g pl брюк
g sg вождя
g pl вспышек
i Отсюда вытекает, что ... It follows from this that...
i давлю, давишь
i делюсь, делишься
Он, дескать, женился I heard he’d got married
g sg нуля
p осмотрю, осмотришь
i ползу, ползёшь, past полз, ползла
p also прибежать | прибегнуть - to resort to; прибежать - to run to
p свалишься; валиться i/сваливаться i
i тону, тонешь; по-/у- p
i увожу, уводишь; p уведу, уведёшь, past увёл, увела
nom pl хоры
У них четверо детей They have four children
i верчу, вертишь
p взойду, взойдёшь, past взошёл, взошла; всходить i/восходить i
g sg воротника
g pl выдумок
i выставляю; p выставлю, выставишь
i даётся; p дамся, дашься, дастся, дадимся, дадитесь, дадутся, past дался, далась
squeeze: жму, жмёшь; harvest: жну, жнёшь
i звеню, звенишь
g pl игрушек
p изложу, изложишь
p исправлю, исправишь
наделать глупостей to do a lot of stupid things
g pl ножек
p оборву, оборвёшь, f past оборвала
no pl
p отберу, отберёшь, f past отобрала
p оторвусь, оторвёшься, past оторвался, оторвалась
no 1st pers sg, очутишься; no i
g pl песенок
p побуду, побудешь, past побыл, побыла, побыло
p подскажу, подскажешь
p советуюсь
p проеду, проедешь
p разовью, разовьёшь, past развил, развила, развило
i реву, ревёшь
рекомендую
i сдаюсь, сдаёшься; p сдамся, сдашься, сдастся, сдадимся, сдадитесь, сдадутся, f past сдалась
i схожусь, сходишься; p сойдёмся, past сошлись
short forms сыт, сыта, сыты
p удержусь, удержишься
i укрепляю; p укреплю, укрепишь
i уношу, уносишь; p унесу, унесёшь, past унёс, унесла
nom pl яйца, g pl яиц, d pl яйцам
по всей вероятности in all probability
трудящиеся the working people
g pl посадок
i вою, воешь
g pl перчаток
g sg большевика
иметь в резерве to have in reserve; экономические резервы economic reserves
g pl винтовок
g sg чертежа
no pl
научно-исследовательский институт (НИИ) research institute
g pl дров
p откажу, откажешь
g pl сеток
i сменяется; p сменюсь, сменишься
Ему было совестно Не was ashamed
как таковой as such
g pl банок; банка пива can of beer
no g pl
g sg богатыря
g pl ботинок
промежуток времени period of time
Времени нету I’ve got no time
колючая проволока barbed wire
газовая плита gas stove
g pl кнопок
nom pl куры, g pl кур
g pl веточек
i вожусь, возишься
i отвожу, отводишь; p отведу, отведёшь, past отвёл, отвела
g пл головок
g pl граммов or (coll) грамм
nom pl дары
i доверяю, доверяешь
g sg жениха
жилая площадь living space, accommodation
p Она завернула за угол She turned the corner
p заслужу, заслужишь
p затяну, затянешь
g pl звёздочек
nom pl князья
g sg ковша
g sg кота
ликвидирую
g pl недр
g pl нянь
обучение грамоте teaching of literacy
i обхожу, обходишь; p обойду, обойдёшь, past обошёл, обошла
nom pl паспорта
g pl пачек
g pl пашен
g sg пса
Пусть будет по-вашему Have it your own way
i кланяюсь; p поклонюсь, поклонишься
p предусмотрю, предусмотришь
i протестую
i размышляю
pr sg в раю
i расширяю
g sg ручья, g pl ручьёв
i сводится
p скажется
nom pl слесаря
i сменяю; p сменю, сменишь
i Мне снилось, что ... I dreamt that…; p Она мне приснилась I dreamt about her
жить по соседству to live nearby
nom pl сосны, g pl сосен
i стесняюсь; He стесняйся Don’t be shy
p уставлюсь, уставишься
энергетические ресурсы energy resources
i вешу, весишь; Сколько это весит? How much does this weigh?
парадная дверь front door
g pl ребятишек
g sg близнеца
g sg земледельца
g pl бровей
правящая верхушка ruling clique
сойти с рельсов to go off the rails
g sg руля
f бабья, n бабье
ворчу, ворчишь
no pres
p приподниму, приподнимешь, past приподнял, приподняла, приподняло
nom pl старшины
су́ндук; g sg сундука́
g pl осей
g pl валенок
g pl гонок
no pl
первого разряда first class
nom pl вдовы
nom pl пуды
nom pl калиток
(indecl)
g sg воробья, g pl воробьёв
g pl пробок
i производится
космический корабль spaceship
i изготовляю; p изготовлю, изготовишь
g pl сеней
g pl шашек
g pl оболочек
командующий армией commander of the army
водяная мельница watermill
i гружу, грузишь; за-/по- р; p погружу́, погру́зишь
p погружу́, погрузи́шь
i содержусь, содержишься
g pl фуражек
g sg козла
nom pl якоря
g pl саней
должным образом properly
g pl путёвок
g sg выпускника
g pl рубок
g sg паренька
в декрете (coll) on maternity leave
nom pl ядра, g pl ядер
i трачу, тратишь; по-/ис- р
g pl рюмок
снежный покров blanket of snow
g pl лыж
no sg, g pl девчат
i анализирую
аплодирую
боковой карман side pocket
i варю, варишь
i влияю, влияешь
i вожу, водишь
p возвращусь, возвратишься
p выражусь, выразишься
Они на даче They’re at their country cottage
двойной подбородок double chin
g sg добровольца
g pl догадок
no pl
no pl
nom pl купола
g pl лавочек
pr sg в ладу́, nom pl лады́; петь в лад to sing in tune; на свой лад in one’s own way
i лечу, лечишь
Она промокла насквозь She got wet through
нефтяная промышленность oil industry
p обижу, обидишь
i одобряю
p отброшу, отбросишь
f охотничья, n охотничье
g sg палача́
g pl палочек
g pl перегрузок
p past подверг, подвергла
три дня подряд three days running
наилучшие пожелания best wishes
p приближусь. приблизишься
i признаюсь, признаёшься; p признаюсь, признаешься
принципиальный вопрос question of principle
nom pl провода
nom pl прожектора
g sg пузыря
p разорву, разорвёшь, f past разорвала
i распространяю
рем(е)нь; g sg ремня
p сдержу, сдержишь
p сломлю, сломишь
f собачья, n собачье; собачья жизнь a dog’s life
p сокращу, сократишь
на стадионе at/in a stadium
nom pl татары, g pl татар
i употребляю
short forms чужд, чужда, чужды
pr sg на балу́, nom pl балы́
i валюсь, валишься; по-/с- р
nom pl веки, g pl век
g pl вешалок
nom pl во́ры, g pl воро́в
Она вот-вот придёт She’ll be here any moment
Вспоминается ... I remember...
встречный ветер head wind
p выращу, вырастишь
господствую
pr sg в дали
p загорится
p залезу, залезешь, past залез, залезла
i заполняю; заполнять бланк to fill in а form
p извлеку, извлечёшь, извлекут, past извлёк, извлекла
g pl каникул
g pl капелек
g pl корок
p наберу, наберёшь, f past набрала
p накоплю, накопишь
p налечу, налетишь
g pl находок
Ему обидно видеть это It hurts him to see that
i отделяю; p отделю, отделишь
p отопру, отопрёшь, past отпер, отперла, отперло
p ощущу, ощутишь
i пашу, пашешь
g sg пласта́
p порожу, породишь
g pl проверок
p пролечу, пролетишь
i/p рассыпа́ться/рассы́паться; p рассы́плется
i растворяется
p растеряюсь
g pl речек
руководствуюсь
Все в сборе Everyone is here
g pl сводок
g семидесяти
составная часть component part, component
p сошлюсь, сошлёшься
g pl тетрадок
g sg тиража́
p украшу, украсишь
хло́п(о)к
хлоп(о́)к
g sg бремени, no pl
i верчусь, вертишься
Она не виновата It’s not her fault
g pl выдержек
g pl горок
g pl дверец
g, d, inst, pr девяноста
no i
g pl ёлок
i жгу, жжёшь, жгут, past жёг, жгла
p завяжу, завяжешь
p заеду, заедешь
p залью, зальёшь, f past залила
i заношу, заносишь; p занесу, занесёшь, past занёс, занесла
p запрещу, запретишь
g pl иголок
p избавлюсь, избавишься
исследую
nom pl клинья, g pl клиньев
мобилизую
p налажу, наладишь
g pl овощей
i осуществляется
p отстою, отстоишь
p переменю, переменишь
g pl перил
p поврежу, повредишь
p прекратится
i присоединяюсь
i равняюсь
развёртываться i/разворачиваться i
в разрезе +g (coll) in the context of
i разъясняю
p расположусь, расположишься
i расширяется
g pl сделок; заключить сделку to do a deal
i сознаю, сознаёшь
p соскочу, соскочишь
g pl стоек
g pl стрелок
струна́; nom pl стру́ны
i цепляюсь
частота́; nom pl часто́ты
g sg чердака
i швыряю
p: по-/шевельнуть 
кошачья шерсть cat fur
g pl юбок
я́стреб; nom pl ястреба́
былое величие former greatness
i вводится
на взводе drunk; agitated
p вложу, вложишь
p выбегу, выбежишь, выбегут
i гремлю, гремишь
i грею, греешь
p забью, забьёшь; бить i/забивать i
p задену, заденешь
записная книжка notebook
p изобрету, изобретёшь, past изобрёл, изобрела
g sg календаря
g pl карточек
i клянусь, клянёшься, past клялся, клялась
i льётся, past лился, лилась
g pl масок
за-, из- p
g sg мяча́
g pl насмешек
p огляжу, оглядишь
p ознакомлюсь, ознакомишься
p осужу, осудишь
p отобью, отобьёшь
g pl палаток
g pl петель
p поделюсь, поделишься
уйти в подполье to go underground
g pl покупок
g полуночи
i помещусь, поместишься
i порчу, портишь; p испорчу, испортишь
g pl посылок
p представлюсь, представишься
p прерву, прервёшь
p привяжу, привяжешь
p проложу, проложишь
i путешествую
p разгляжу, разглядишь; no i
p разыщу, разыщешь
p рассею, рассеешь
i таю, таешь
i ревную
i рисую; p нарисую
g pl складок
short forms: склонен, склонна, склонны
p слезу, слезешь, past слез, слезла
i стыжусь, стыдишься
g pl сумок
g pl схваток; схватки (muscle) contractions
i темнеет; по-/с- р
g pl тёток
i топлю, топишь; p по-/y-
g pl трубочек
i трясу, трясёшь, past тряс, трясла
i удаляюсь
i уделяю; уделять внимание +d to give/pay attention to sth
(m/f)
g pl уток
на юридическом факультете in the law faculty
i целуются
g pl яблонь
(m)
g sg вреда́
(m pl) g pl выборов
(f)
g pl гимнастёрок
g sg гроша́; без гроша penniless
заветная цель cherished goal; заветная мечта secret dream
p запою, запоёшь
p затрачу, затратишь
g sg знатока́
(f)
конский завод stud farm
i кружусь, кружишься
g pl кучек
g pl ловушек
g sg материка́
(f)
(f)
g pl мышек; под мышкой under one’s arm
p наведу, наведёшь, past навёл, навела; навести порядок to put things in order
(f)
некто Сидоров a certain Mr Sidorov
g pl новинок
p оборвусь, оборвёшься, f past оборвалась
оформление документов completion/registration of documents
p переберу, переберёшь, f past перебрала
(i~p) перереза́ть/перере́зать; перережу, перережешь
(f)
i пляшу, пляшешь
nom pl погреба
g полувека
g pl поправок
Он попросту устал He’s just tired
(f)
p посмеюсь, посмеёшься
or посередине 
i поясняю
(f)
i предъявляю; p предъявлю, предъявишь
p прилечу, прилетишь
f птичья, n птичье
p разгромлю, разгромишь
p раскроюсь, раскроешься
рыбная ловля fishing
p собьюсь, собьёшься
i склоняюсь; p склонюсь, склонишься
no pl
nom pl снохи (of husband’s mother: невестка)
прогноз погоды weather forecast
g pl справок; наводить справки о +pr to make enquiries (about)
спрос на импортные товары demand for imported goods
i трясусь, трясёшься, past трясся, тряслась
g pl уступок
g sg четверга
i чувствуется
i шепчусь, шепчешься
g pl берёзок
pr sg в бору, nom pl боры
g sg борща
g pl бочек
i выявляю; p выявлю, выявишь 
валяйте! (coll) go ahead!
(f)
i вьётся
i влюбляюсь; p влюблюсь, влюбишься
i возглавляю; p возглавлю, возглавишь
i воображу, вообразишь
g pl воронок
p вышлю, вышлешь
(f)
no pl
деви́чий or де́вичий; девичья фамилия maiden name
i делю, делишь
p денусь, денешься
pr sg в жару
nom pl инспектора
n indecl
g pl колоколен
(i)
i молюсь, молишься
(m)
nom pl ноздри, g pl ноздрей
g pl нянек
nom pl очи, g pl очей
g pl открыток
p оторву, оторвёшь, past оторвал, оторвала, оторвало
no pl
i передаётся
g sg петуха
i планирую
подавляющее большинство the great majority
p подбегу, подбежишь, подбегут
p помилую; no i; Господи, помилуй Lord, have mercy
g pl поставок
i тушу, тушишь
i предполагается it is proposed
p предстану, предстанешь; предстать перед судом to appear in court
(f)
p прижмусь, прижмёшься
p приоткрою, приоткроешь
p разложу, разложишь
p разложу, разложишь
i рискую
i скольжу, скользишь
p снабжу, снабдишь
i сочувствую
процентная ставка interest rate
сукин сын son of a bitch
i тычу, тычешь; p ткну, ткнёшь
i треплю, треплешь
g pl тропинок
в упор point-blank; сделать упор на +pr or a to emphasize
i утра́чиваю, утра́чиваешь; p утрачу, утратишь
ха́ос or хао́с
срок хранения sell-by date; камера хранения left luggage office
(also целая) единое целое a single whole; одна целая (и) три десятых one point three (1.3)
g pl цепочек
g pl чернил
i чищу, чистишь
g pl щей
i эксплуатирую
на авось on the off-chance
античный мир the ancient world
g pl брызг
по велению совести according to the dictates of one’s conscience
i гоняю, гоняешь
милостивый государь Dear Sir
i граблю, грабишь
i двигаю or движу, движешь
nom pl дворяне, g pl дворян
p донесу, донесёшь, past донёс, донесла
i жую, жуёшь
i загоняю; p загоню, загонишь, f past загнала
p задушу, задушишь
p зажму, зажмёшь
p закажу, закажешь
p закушу, закусишь
земляной пол earth floor
i знакомлю, знакомишь
поставить кого-нибудь в известность о +pr to notify s.o. about sth
no pl
nom pl колосья, g pl колосьев
g pl командировок; в командировке on a business trip etc.
g sg костыля
i past креп, крепла
g pl кружек
g pl крупинок
i кроется; Причина кроется в ... The cause lies in ...
p навалюсь, навалишься
p накажу, накажешь
p нападу, нападёшь, past напал, напала
p окрашу, окрасишь
f; в окрестностях in the vicinity
g sg пня
p перееду, переедешь
p пересеку, пересечёшь, пересекут; past пересёк, пересекла
i пишется; Как это пишется? How do you spell that?
i плюю, плюёшь
g pl поговорок
i гублю, губишь; p погублю, погубишь
i подношу, подносишь; p поднесу, поднесёшь, past поднёс, поднесла
p подъеду, подъедешь
p помяну, помянешь
i предвижу, предвидишь; no р
взойти на престол to ascend the throne
i пячусь, пятишься
i радует; p обрадую
в разгаре +g at the height of
родственные связи family ties
i рычу, рычишь
вечер самодеятельности amateur concert
найти сбыт to find a market, sell well
p сварю, сваришь
nom pl сёдла, g pl сёдел
p сожму, сожмёшь
Она владеет русским языком в совершенстве She speaks perfect Russian
p созрею, созреешь
i сопротивляюсь
p сорвусь, сорвёшься, f past сорвалась
g pl строчек
p стяну, стянешь
g pl табуреток
nom pl тополя
предложить тост за +а to propose a toast to
i увожу, увозишь; p увезу, увезёшь, past увёз, увезла
i удивляю; p удивлю, удивишь
в установленном порядке in the prescribed manner
p устою, устоишь; no i
g pl хлопот, d pl хлопотам; без хлопот without difficulty
i чиню, чинишь; p починю, починишь; чинить i/починять i
i чую, чуешь
g pl балок
g pl бородок
Бывало, она вставала в шесть утра She would get up at 6 a.m.
p выложу, выложишь
i~p; выреза́ть/вы́резать; p вырежу, вырежешь
i гашу, гасишь
i past гиб, гибла
i грызу, грызёшь, past грыз, грызла
(i/p) демонстрирую
i доводится; p доведётся, довелось; Ей довелось побывать в Париже She had occasion to visit Paris
p доживу, доживёшь
p закреплю, закрепишь
p запущу, запустишь
p застыну, застынешь
p затею, затеешь
p past зarax, затихла
nom pl иглы
почётный караул guard of honour
g pl касок
g pl кистей
g кое-кого
 pl корточки; сидеть на корточках to squat
i критикую
i кручусь, крутишься
i крою, кроешь
nom pl лапти, g pl лаптей
g pl ласк caress; g pl ласок weasel
g sg льва
i лью, льёшь
no pl
nom pl местечки, g pl местечек
i мечусь, мечешься
g sg монтажа
p набью, набьёшь
p наговорить глупостей to talk a lot of nonsense
p нажму, нажмёшь
f намерена
g pl ниточек
p обрету, обретёшь, past обрёл, обрела
p отыщу, отыщешь
p переглянусь, переглянешься
g sg пирога
i подаюсь, подаёшься; p подамся, подашься, подастся, подадимся, подадитесь, подадутся; подаваться
p позабуду, позабудешь
p покошусь, покосишься
p предпочту, предпочтёшь, past предпочёл, предпочла
p присмотрюсь, присмотришься
p приспособлю, приспособишь; приспосабливать i or приспособлять i
p пробегу, пробежишь, пробегут
i продаюсь, продаёшься
p развяжу, развяжешь
p раздавлю, раздавишь
p распущу, распустишь
i расставляю; p расставлю, расставишь
nom pl рога
g pl рыбок
g pl салфеток
p сбегу, сбежишь, сбегут
i скачу, скачешь
i скрипит; про- р/скрипнуть р
в общей сложности all in all
p снижу, снизишь
i совершенствую
i стону, стонешь
i томлюсь, томишься
i тоскую
i точу, точишь
g pl троек
g pl туфель
p угощу, угостишь
i роняю, роняешь; p уроню, уронишь
g pl ущелий
i хороню, хоронишь
i шью, шьёшь; p сошью, сошьёшь
f эка, п экое
(i/p) атакую
g pl басен
g pl бомбардировок
i бреюсь, бреешься
вереница автомобилей a line of cars
nom pl вёсла, g pl вёсел
p выбью, выбьешь
g pl голубей
g pl горстей
i диктую
жилищные условия housing conditions
i жру, жрёшь, f past жрала
i забега́ть вперёд to run ahead; p забегу, забежишь, забегут; забежать вперёд to run ahead
р забе́гать
p зарастёт, past зарос, заросла
p затянусь, затянешься
g pl заявок
g sg земляка
i каплю, каплешь
g pl кепок
g sg конька
i контролирую
indecl
g sg кошелька
с- р; по- р
f
g sg малыша
g pl миль
i мучиться or мучаться; p за- or из-
i надлежит; past надлежало
p наложу, наложишь
p наткнусь, наткнёшься
nom pl низы
i ношусь, носишься
m/f; g pl одиночек; мать-одиночка unmarried mother; в одиночку single-handed
p оживу, оживёшь, past окреп, окрепла
g sg осла
p осмотрюсь, осмотришься
g pl остриёв
nom pl паруса
i перечисляю
p повышусь, повысишься
p подавлю, подавишь
i подчиняюсь
p поженимся
g sg поставщика
Похоже на то, что ... It looks as if…
p предотвращу, предотвратишь
i
p просижу, просидишь
p прослежу, проследишь
p прощусь, простишься
p пущусь, пустишься
p разденусь, разденешься
p размещу, разместишь
g sg рычага
p сгорю, сгоришь
g pl скрипок
g sg словаря
служебное время office hours
p согласую, согласуешь
g pl соседок
p С ней не соскучишься You won’t get bored with her; Она соскучилась по мужу She misses her husband
p спохвачусь, спохватишься
спрашивается the question is
p стисну, стиснешь
p схвачусь, схватишься; схватываться/хвататься i
i Что здесь творится? What’s going on here?
i толкую, толкуешь
i трепещу, трепещешь
nom pl тропы
p украду, украдёшь, past украл, украла
p укроюсь, укроешься
i умоляю
p установится
i устремляюсь; p устремлюсь, устремишься
i хвалю, хвалишь
g sg хомута; надеть себе хомут на шею to impose a burden on os
g sg чайка, partitive g чайку; Вы не хотите чайку? Would you like some tea?
g pl шаек
i белеет
i бреду, бредёшь, past брёл, брела
g pl будней
i
i веет
p взвешу, вывешишь; вешать i/взвешивать i
p возложу, возложишь
восходящая звезда rising star
Цены повысились втрое Prices have risen threefold
g pl вывесок
i вывожу, вывозишь; p вывезу, вывезешь, past вывез, вывезла
p вышибу, вышибешь, past вышиб, вышибла
g pl двоек
g pl детишек
i довольствуюсь
достигнуться p/достичься p
p замру, замрёшь, замер, замерла
i заору, заорёшь
p зашумлю, зашумишь
разо- p/обо- р
no pl
nom pl колья, g pl кольев
i колю, колешь; раз- р; за- р
g pl коробочек
i лаю, лаешь
m
f Ему лень идти He can’t be bothered to go
i маню, манишь
p наживу, наживёшь, past нажила
намного лучше much better
p наплюю, наплюёшь; Ей наплевать She couldn’t care less
i недостаёт
f
g pl обеден
p обнажу, обнажишь
no i
отпечатки пальцев fingerprints
i охочусь, охотишься
за пазухой in one’s bosom
g pl перегородок
p перекрещусь, перекрестишься
p перекрещусь, перекрестишься
p переменюсь, переменишься
nom pl пилы
nom pl плиты
p подведу, подведёшь, past подвёл, подвела; подвести итоги to sum up
g pl подружек
g pl постановок
p постарею, постареешь
i превосхожу, превосходишь; p превзойду, превзойдёшь, past превзошёл, превзошла
g sg премьер-министра
p преобразую
p прибью, прибьёшь
p прислонюсь, прислонишься
g pl прогулок
публичный дом brothel
p разобьётся
nom pl рёбра, g pl рёбер
nom pl русла, g pl русл
g pl мышц
p сольюсь, сольёшься, past слился, слилась
p снижусь, снизишься
p созову, созовёшь, f past созвала
вы- p; стереть p
g sg сука, pr sg на суку, nom pl суки, g pl суков or сучья, сучьев
i сыплется, сыплются
i таюсь, таишься
n indecl
i
p угожу, угодишь
p упомяну, упомянешь
p усядусь, усядешься, past уселся, уселась
p ухвачусь, ухватишься
p уцелею, уцелеешь
i хлещу, хлещешь
во хмелю tipsy
g sg чугуна
i шиплю, шипишь
nom pl яблочки, g pl яблочек
g pl яслей
безымянный палец ring-finger
g sg бича
благие намерения good intentions
pr sg в бреду
i брею, бреешь
i бушую, бушуешь
верховая езда horse-riding
m
(m) g pl весов
g pl вечеринок
p влезу, влезешь, past влез, влезла
i внедряю
p вцеплюсь, вцепишься
p вымою, вымоешь; мыть i, вымывать i
g pl выходок
g sg гаража
i Документ гласит ... The document states ...
g sg глуши
p доеду, доедешь
i дразню, дразнишь
i дремлю, дремлешь
nom pl дыры
p заблужусь, заблудишься
p завалю, завалишь
p заинтересуюсь
p затоплю, затопишь; затапливать i; затоплять i
защитные очки goggles
i Она в списке не значится She’s not listed
p избавлю, избавишь
i измеряю
i исполняется
g sg клопа
g sg кнута
i колышется
командные высоты the commanding heights
g sg кузнеца
g pl кукушек
p наберусь, наберёшься, f past набралась
p нагоню, нагонишь, f past нагнала
накануне Нового года on New Year’s Eve
(i/p) оборудую
i овладеть
p оживлюсь, оживишься
g sg особняка
nom pl остроты
p отвезу, отвезёшь, past отвёз, отвезла
работать с полной отдачей to be a dedicated worker
каждый в отдельности each separately; в отдельности taken separately
p отменю, отменишь
i отсутствую
p очищу, очистишь
g sg плаща
i плету, плетёшь, past плёл, плела
как положено as is the done thing
p погружусь, погрузишься
g pl покрышек
p предам, предашь, предаст, предадим, предадите, предадут, f past предала
p приготовлюсь, приготовишься; приготавливаться i/ приготовляться i
p приспособлюсь, приспособишься
i притворяюсь
p притихну, притихнешь, past притих, притихла
p пробьюсь, пробьёшься
g sg проводника
i проношусь, проносишься; p пронесусь, пронесёшься, пронёсся, пронеслась
p прошепчу, прошепчешь
f
политика кнута и пряника carrot and stick policy
i раздаю, раздаёшь; p раздам, раздашь, раздаст, раздадим, раздадите, раздадут, f past раздала
nom pl ремёсла, g pl ремёсел
(f) g sg ржи, inst sg рожью, pr sg во ржи
f
p свалю, свалишь; валить/сваливать i
i сетую, сетуешь
g sg слона
p смущу, смутишь
g pl снежинок
p согрею, согреешь
g pl сопок
в сопровождении +g accompanied by
p стащу, стащишь
g pl стоянок; стоянка такси taxi rank
p струшу, струсишь
p съезжу, съездишь
g pl таблеток
i твержу, твердишь
i травлю, травишь
p умоюсь, умоешься
f
g pl шапочек
g sg шута
pr sg в аэропорту
i coll баловатьбалую
g pl бутылочек
валуна
g pl варежек
i ворую
p впаду, впадёшь, past впал, впала
i вставляю; p вставлю, вставишь
p высажусь, высадишься
p выскажусь, выскажешься
g pl добавок
p докачусь, докатишься
(m) nom pl домишки, g pl домишек
i дымлю, дымишь
i жажду, жаждешь
p закроюсь, закроешься
p застряну, застрянешь
nom pl змеи, g pl змей, d pl змеям
g sg каблука
g sg клока, nom pl клочья, g pl клочьев or клоки, клоков
g pl косынок
f
куриная память memory like a sieve
i лажу, лазишь
g pl ленточек
nom pl мётлы, g pl мётел
no pl
g sg монастыря
Ему неохота He doesn’t feel like it
g pl нехваток
f pl; g pl носилок
p обгоню, обгонишь, f past обогнала
+g в обрез none to spare; Времени в обрез Time is very short
p обхвачу, -атишь
f
p одолею, одолеешь
g pl ожерелий
nom pl округа
p опустеет
g sg орла
g pl отметок
g pl парнишек
p пересмотрю, пересмотришь
i
повестка дня agenda
g pl повязок
p подожгу, подожжёшь, подожгут, past поджог, подожгла
p подорву, подорвёшь, f past подорвала
p подтяну, подтянешь
nom pl полы
nom pl поленья, g pl поленьев
nom pl полотна, g pl полотен, d pl полотнам
nom pl полуострова
пособие по безработице unemployment benefit
i правлю, правишь
i праздную
p прибегу, прибежишь, прибегут
p приберу, приберёшь, f past прибрала
p привяжусь, привяжешься
p приставлю, приставишь
i пристаю, пристаёшь; p пристану, пристанешь
p провозглашу, провозгласишь
p проглочу, проглотишь
g sg продавца
p
p пролью, прольёшь, f past пролила
p промолчу, промолчишь
p проскочу, проскочишь
p прославлюсь, прославишься
p просмотрю, просмотришь
i противостою, противостоишь
p развалится
g pl расписок
i распределяется
i ращу, растишь
p рванусь, рванёшься
= родной
i рою, роешь
g pl сестрёнок
f
g pl словечек
i сосу, сосёшь
g pl спален
p спасусь, спасёшься, past спасся, спаслась
p спишу, спишешь
спичечная коробка matchbox
p станется
p past стих, стихла
p сформулирую; формулировать (i/p)
g pl съёмок
p съеду, съедешь
в такт музыке in time to the music; отсутствие такта tactlessness
i торможу, тормозишь
i углубляюсь
p улечу, улетишь
g pl уст, d pl устам; из уст в уста by word of mouth
f
g pl фигурок
g pl форточек
i цвету, цветёшь, past цвёл, цвела
nom pl цыплята, g pl цыплят
на цыпочках on tiptoe
nom pl черепа
i чудится; по- p/при- р; p Мне почудилось, что я слышу шаги I thought I heard footsteps
g pl чулок
g pl штучек
(i/p) адресую
g pl арок
m
g pl белок
g sg блина
i благословляю; p благословлю, благословишь
g pl булок
nom pl веера
g pl верховьев
p взлечу, взлетишь
i визжу, визжишь
i возвожу, возводишь
p возвращу, возвратишь
p вскрою, вскроешь
p выпишу, выпишешь
p выпрямилюсь, выпрямишься
p выхвачу, выхватишь
i горюю, горюешь
nom pl горожане, g pl горожан
двоюродный брат cousin; двоюродная бабушка great-aunt; двоюродный дед great-uncle, grand-uncle
f
i душу, душишь
f
g sg жука
p заварю, заваришь
p заведусь, заведёшься, past завёлся, завелась; Мотор завёлся The engine started
глушить i/заглушать i
p загужу, загудишь
p задеру, задерёшь
i заимствую
f
f
g pl закусок
p past замёрз, замёрзла
(= запасной)
p заряжу, зарядишь
p застрелю, застрелишь
p заткну, заткнёшь
f
m
i истребляю; p истреблю, истребишь
в канун +g on the eve of sth
i кашляю
g sg колпака; ночной колпак nightcap
g pl колясок
nom pl комья, g pl комьев
i кошу, косишь
g pl кyлиc; за кулисами behind the scenes
g pl машинок; пишущая машинка typewriter
медикаменты medical supplies, drugs
f; pr sg на мели high and dry
g sg меча
nom pl мещане, g pl мещан
милостивый государь Dear Sir
g sg москвича
i мщу, мстишь
m
i past навис, нависла; p навяжу, навяжешь
p награжу, наградишь
накопится; накапливаться i/накопляться i
Все необходимые условия налицо All the essential conditions are present
i
f; pr sg на мели high and dry
= неужели
p обожгу, обожжёшь, обожгут, past обжёг, обожгла
p обменяемся;обменяться взглядами to exchange glances
оборонная промышленность defence industry
g pl оговорок; согласиться с оговорками to agree with reservations
p past озяб, озябла
i оскорбляю; p оскорблю, оскорбишь
p остыну, остынешь
p отворю, отворишь
f
i оформляю; p оформлю, оформишь
(p c-) to burn, scorch; (p o-) singe
i пасу, пасёшь, past пас, пасла
g sg пайка
p перевезу, перевезёшь, past перевёз, перевезла
p перевяжу, перевяжешь
p перехвачу, перехватишь
i
пищевая промышленность food industry
i бледнею, бледнеешь; p побледнею, побледнеешь
p побоюсь, побоишься
p повисну, повиснешь, past повис, повисла
i поддаюсь, поддаёшься
p подложу, подложишь
p покроюсь, покроешься
Северный полюс North Pole
(Мне) помнится I remember
p поправлюсь, поправишься
p поравняюсь
p постановлю, постановишь
p потружусь, потрудишься; Потрудитесь закрыть дверь Could I ask you to close the door?
g pl предпосылок
i преподаю, преподаёшь
i претендую
p приподнимусь, приподнимешься, past приподнялся, приподнялась
незаконное присвоение misappropriation
p пришью, пришьёшь
метод проб и ошибок trial and error
g pl пыток; Попытка не пытка It won’t hurt to try
p разгорится
p Простите, я не расслышала Sorry, I didn’t catch that
p рассужу, рассудишь
f
i расходую
g pl свечек
p свяжусь, свяжешься
m/f; nom pl сироты
m/f; nom pl сироты
i соплю, сопишь
i соревнуюсь
p Механизм сработал The mechanism worked
i сыплю, сыплешь
i тру, трёшь, past тёр, тёрла
f
i тороплю, торопишь
i трещит
f; g pl тростей
m
p улягусь, уляжешься, улягутся, past улёгся, улеглась
p уловлю, уловишь
p упущу, упустишь
усики small moustache
g pl устьев
f
i чередуюсь
i черчу, чертишь
i Она не числится в этом списке She’s not on this list
g шестисот
g pl шкатулок
g pl щёток
i экономлю, экономишь
g pl этикеток
f
g pl братишек
i вдохновляю
g pl ведьм
f
g pl вишен
p влечу, влетишь
i вожусь, водишься
p возобновлю, возобновишь
m
i воспроизвожу, воспроизводишь
p втяну, втянешь
p выжму, выжмешь
p высажу, высадишь
p высплюсь, выспишься
i вяжу, вяжешь
гуманитарные науки the Arts, humanities
g sg денька
g pl джинсов
i дружу, дружишь
g pl дырок
Есть желающие пойти в кино? Does anyone want to go to the cinema?
законченный мастер consummate master
p запечатлею, запечатлеешь
nom pl зёрнышки, g pl зёрнышек
f
p изгоню, изгонишь, f past изгнала
i измеряется
p израсходую
i/p иллюстрирую
i именую
m; g sg инвентаря
often pl капиталовложения
i качу, катишь
nom pl козы
m; g pl козырей
g pl коленок
колючая проволока barbed wire
g sg комара
i/p конфискую
nom pl концлагеря
g pl косточек
nom pl котята, g pl котят
i крашу, красишь; вы-/о-/по- р
g pl крошек
i кряхчу, кряхтишь
nom pl кузова
культ личности cult of personality
i лечусь, лечишься
g pl линеек
nom pl лоскуты, g pl лоскутов or nom pl лоскутья, g pl лоскутьев
g pl макушек; Ушки на макушке I’m all ears
i маневрирую
i мечу, метишь
g pl мещанок
no pl
g pl морщинок
p навалю, навалишь
p нагрею, нагреешь
= надо
поить i/напаивать i; i пою, поишь
выйти из обихода to go out of use
p оболью, обольёшь, f past облила
g pl обложек
с опаской nervously, cautiously
i отделяюсь
p перейму, переймёшь, past перенял, переняла, переняло
g pl пересадок
p переспрошу, переспросишь
i повинуюсь; повиноваться р (past only)
i повожу, поводишь
p подвешу, подвесишь
i подлежит; Это не подлежит сомнению This is indisputable
p подружусь, подружишься
p подскочу, подскочишь
(p) поинтересуюсь
n indecl
p попью, попьёшь, f past попила
p поспею, поспеешь
p посыплется
i
i щажу, щадишь; p пощажу, пощадишь
i предшествует
n pl; g pl прений
p привью, привьёшь, past привила
nom pl призы
p прикреплю, прикрепишь
p приучу, приучишь
g pl причёсок
i проповедую
p прорвусь, прорвёшься, past прорвался, прорвалась
p проре́зать, проре́жу, проре́жешь; прореза́ть i/проре́зывать i
p прославлю, прославишь
nom pl простыни, g pl простынь, d pl простыням
g pl птичек
Пускай говорит Let him speak
g sg пустыря
i
f разбойничья, n разбойничье
p разведусь, разведёшься, past развёлся, развелась
p разлечусь, разлетишься
p размещусь, разместишься
f
p разорвётся, past разорвался, разорвалась
i Курить не разрешается Smoking is not permitted
p расправлюсь, расправишься
p расцвету, расцветёшь, past расцвёл, расцвела
i/p ремонтирую
i робею, робеешь
i роюсь, роешься
nom pl седины
g семисот
p склоню, склонишь
мешать i/смешивать i
nom pl смолы
pr sg в спирте or в спирту, nom pl спирты
(also ставня) g pl ставней and ставен
p стемнеет
p сотру, сотрёшь, past стёр, стёрла
i суечусь, суетишься
g pl счётов
i топчусь, топчешься
g pl тренировок
g pl третей
g pl тучек
g pl удочек
i управляюсь
i характеризуюсь
p
i хлопочу, хлопочешь
i хриплю, хрипишь
i
f
f
i чернею, чернеешь
чёртова дюжина baker’s dozen
no pl; на чужбине in foreign parts
i шуршу, шуршишь
i агитирую
= или
i балуюсь
спиртные напитки alcoholic drinks
g sg башмака
g pl безделушек
f
i сношу, сносишь; p снесу, снесёшь, past снёс, снесла
i ближусь, близишься
i
g pl боеприпасов
g pl боен
Ей боязно She’s afraid
твёрдая валюта hard currency
пуститься вдогонку за кем-нибудь to rush off after s.o.
i Мне не верится, что ... I cannot believe that...
p устарею, устареешь
p взорвусь, взорвёшься
g pl взяток
p утону, утонешь; тонуть i/утопать i
p влеку, влечёшь, влекут, past влёк, влекла
f
p past воздвиг, воздвигла
i/p воздействую
p возмущу, возмутишь
p past воскрес, воскресла
предвыборная кампания election campaign
жить врозь to live apart
выборная должность elective office
p выбуду, выбудешь
p выживу, выживешь
p вымету, выметешь, past вымел
i выполняется
f
i гоняюсь
g pl гражданок
i греюсь, греешься
g sg дельца
f
no pl
g pl домен
Ей было досадно, что он опоздал She was annoyed that he came late
f
i деру, дерёшь, f past драла; разо- p/со- p
f
m, g pl дядек
f
f
nom pl жерла, g pl жерл
nom pl жернова
p забреду, забредёшь, past забрёл, забрела
p загорожу, загородишь
g pl задержек
p зазвенит
p залажу, заладишь
p залечу, залетишь
p зальюсь, зальёшься, past залился, залилась; залиться смехом to burst out laughing
p замаскирую
g pl западней
p заражу, заразишь
p зарежу, зарежешь
i заслоняю
p затворю, затворишь
p затеряюсь
m; nom pl зятья, g pl зятьёв
i издаётся
классовая борьба class struggle
g pl пятилеток
g pl чаек
nom pl кислоты
g sg австрийца
nom pl окорока
g sg красноармейца
вычислительная техника computers
i
g pl заготовок
f
f
f
воздушная трасса airway
f казачья, n казачье
g pl кухарок
выйти в эфир to go on the air
no pl
nom pl кителя
p обожду, обождёшь
(nom pl пропуска) pass, permit; (nom pl пропуски) blank, gap
осадки precipitation (rain, snow)
растительное масло vegetable oil
g pl ячеек
озимые winter crops
m; g sg хрусталя
nom pl плуги
nom pl очки, g pl очков; в очках wearing glasses
g sg рудника
nom pl хутора
товары широкого потребления consumer goods
световые полосы strips of light
nom pl руды
g pl бабок
g pl нар
g pl шестёрок
nom pl брусья, g pl брусьев
= даже
отчётный доклад report
g sg платежа
= пока
= батюшка
f
f
устный экзамен oral examination
g pl гармошек
= городской комитет
g pl накидок
p отставлю, отставишь
m
i прошусь, просишься
g sg штыка
валовой доход gross income; валовой национальный продукт gross national product
nom pl голы, g pl голов
g sg козырька; взять под козырёк to salute
nom pl вожжи, g pl вожжей
опрос общественного мнения opinion poll
g pl перевозок
nom pl семечки, g pl семечек
Нам суждено было встретиться We were fated to meet
m
g pl жилеток
f
i изготовляется
лишение свободы imprisonment
m
Это чревато опасностью This is fraught with danger
f
g pl конюшен
g pl лягушек
pr sg на мысе or на мысу
i/p обследую
g sg плота
i
p -творю, -творишь
f; на рысях at a trot
g sg рюкзака
i сушу, сушишь
m
g pl катушек
g sg китайца
g pl плавок
поваренная книга cookery book
дом для престарелых old people’s home
no pl
f
nom pl щепы, g pl щеп, d pl щепам
nom pl ягнята, g pl ягнят
g sg боба
g pl булавок
всемерная помощь all possible assistance
f
женское чутьё female intuition
p прослежусь, прослезишься
nom pl скулы
g pl шор
в бабушкином доме in grandmother’s house
f
p извещу, известишь
g sg калача; тёртый калач old hand
g pl кличек
g pl кочек
=курица
i леплю, лепишь; вы-, с- р
i
i познаю, познаёшь
p приостановлюсь, приостановишься
сношения dealings, relations
g pl упряжек
ходовые мнения popular opinions
f
g pl беседок
g pl брошек
i варьирую
i
i дивлюсь, дивишься
nom pl желоба
романтическая жилка romantic streak
nom pl катера
g sg тюка
до отвала to satiety
по истечении +g on the expiry of, after
g pl лепёшек
g sg лесника
g pl машинисток
осыпа́ть/осы́пать; p осы́плю, осы́плешь
nom pl пёрышки, g pl пёрышек
g pl приписок
i рисуюсь
g pl рукояток
g sg серпа
f
g pl собачонок
g pl струек
pr sg в сыре/в сыру, nom pl сыры
g pl угодий; полевые угодья arable land; охотничьи угодья hunting grounds
g pl кастрюль
m
g pl кишок
m; g sg кобеля
Он сообщил кое-какие новости He gave us certain items of news
коммерческий магазин privately-owned shop
i колочу, колотишь
g pl колючек
m pl; g pl коньков
g sg коньяка
(i/p) координирую
i
nom pl копья, g pl копий
коммунальная квартира communal flat (shared by several families)
i крадусь, крадёшься, past крался, кралась
i кружу, кружишь
m pl; g pl курсов
f
g pl ловeль; рыбная ловля fishing
g pl люлек
f
f мамина, n мамино
одним махом at one stroke
f
i мечу, мечешь
i/p механизирую
pr sg во мху
g sg муравья, g pl муравьёв
f
i мычу, мычишь
g pl надстроек
наличные деньги cash; наличный расчёт cash payment
p насажу, насадишь
населённый пункт locality, place
испугать насмерть to frighten to death
p натяну, натянешь
невесть почему God knows why
f
непременное условие sine qua non
g pl ноток; нотка недоверия note of distrust
p обложу, обложишь
p обложу, обложишь
p обнимусь, обнимешься, pl past обнялись
p обогащусь, обогатишься
g pl обоев
i обороняюсь
p оброню, обронишь; no i; обронить замечание to let fall a remark, comment
g pl оков
p опережу, опередишь
f
p ослабею, ослабеешь; слабеть/ослабевать i
p оснащу, оснастишь
p остригу, острижёшь, остригут, past остриг, остригла; стричь i/ остригать i
p отбуду, отбудешь, f past отбыла
p отвалю, отвалишь
p переброшу, перебросишь
p перекрою, перекроешь
i переношусь, переносишься
p переступлю, переступишь
i пилю, пилишь
f
i подавляю; подавить
p подопру, подопрёшь, past подпёр, подпёрла
i подставляю; p подставлю, подставишь
p пожертвую
p помашу, помашешь
g pl пометок
попутный ветер favourable wind
p порадую
p порадуюсь
p постигну, постигнешь, past постиг, постигла
p потолкую
g pl похорон, d pl похоронам
Почём виноград? How much are the grapes?
i препятствую
p пригляжусь, приглядишься
p прихвачу, прихватишь
i причиняю
p пробужу, пробудишь; будить i/пробуждать i
p пробуду, пробудешь, past пробыл, пробыла, пробыло
продовольственный магазин food shop
f
f
p пролезу, пролезешь, past пролез, пролезла
p променяю
полноценная пища proper food
i противопоставляю; p противопоставлю, противопоставишь
g pl пятёрок
p разинуть рот to gape
p разогрею, разогреешь
p разрастётся, past разросся, разрослась
разреза́ть/разре́зать; p разре́жу, разре́жешь
разъезды travels
also распроститься р
(i/p) реконструирую
сталинские репрессии Stalin’s purges
g sg родника
реагирую; про-/от- р
g pl самок
p свергну, свергнешь, past сверг, свергла
i В июне светает рано It gets light early in June
p сдержусь, сдержишься
nom pl свитера
f
g sg сибиряка
сквозной ветер draught; сквозной поезд through train
g pl склянок
g pl сковородок; dim of сковорода frying pan
p скопится
g pl скороговорок; говорить скороговоркой to gabble
i славлюсь, славишься
p смою, смоешь
p снимусь, снимешься, past снялся, снялась
g pl собачек
g sg сорняка
i/p
m
сущая правда the honest truth
g sg сюртука
g pl табличек
танковый полк tank regiment
nom pl телята, g pl телят
Он толком ничего не сделает Не won’t do anything properly
p удеру, удерёшь, f past удрала
p управлюсь, управишься
p условлюсь; условишься
p услышу, услышишь
p ухвачу, ухватишь
фактическое признание de facto recognition
i формирую
f
m; g sg червя, nom pl черви, g pl червей
g sg шалаша
g pl щёлок
g sg щита
m; g sg янтаря
pr sg в аду
m; g sg алтаря
ассигнования на народное образование funding for education
f
бездна дел a huge number of things to do
pl; g pl белил
i берегусь, бережёшься, берегутся, past берёгся, береглась
исчезнуть бесследно to vanish without trace
g sg блиндажа
g sg богача
i бомблю, бомбишь
бро́ня
броня́
g pl будок
g sg винта
собрать воедино to bring together
вожака
возвышенный стиль elevated style
g sg вола
вопиющее безобразие absolute disgrace
g восьмисот
входная плата entrance fee
p выгружу, выгрузишь
i выдаюсь, выдаёшься
p выздоровею, выздоровеешь
i гну, гнёшь
ни к чему не годный worthless
g pl горлышек
i грожусь, грозишься
i грохочу, грохочешь
nom pl гряды, d pl грядам
g pl грядок
no pl
p доверяться
i дохнет, past дох, дохла
p дохну, дохнёшь
g pl дощечек
g pl доярок
f
nom pl дуги
g pl дудок; (coll) Дудки! Not likely! No way!
жалобная книга complaints book
p забормочу, забормочешь
p заброшу, забросишь
i/p
p past заглох, заглохла
p загоняю
загробный мир the next world
pr sg на заду, nom pl зады
задолго до конца long before the end
p закипит
g pl закладок
p заночую
p запасусь, запасёшься, past запасся, запаслась
p засяду, засядешь, past засел, засела
p затаить дыхание to hold one’s breath
i затрудняю
g pl затяжек
i зеленеет
i/p констатирую
f
i зрею, зреешь
p изобью, изобьёшь
g pl именин
военная истерия war hysteria
g pl каморок
i каюсь, каешься
кипа бумаг pile of papers
g sg кита
кирпичная кладка bricklaying
no pl
nom pl колесики, g pl колесиков
nom pl колечки, g pl колечек
f
i кормлюсь, кормишься
i кривляюсь
also кружева pl
g pl кудрей
n indecl
i лажу, ладишь
m/f; g pl лебедей
g sg ледника
g pl лесенок
i лижу, лижешь
nom pl лисы
i
налоговые льготы tax relief
f медвежья, п медвежье; медвежья услуга dubious benefit
= между
i мёрзну, мёрзнешь; past мёрз, мёрзла
из- р; по-/при- р
i
pr sg в меху; nom pl меха
m; g sg миндаля
no g pl
g sg мудреца
i мчу, мчишь
g pl надбавок
i населяю
= навсегда
сон наяву daydream
f
= чем
Некого спросить There’s no-one to ask
Ей не с кем играть She has no-one to play with
short forms неправ m, неправа f, неправы pl
g pl ножниц
nom pl норы, g pl нор, d pl норам
i обвожу, обводишь
m
p обосную, обоснуешь
i обостряю
p обую, обуешь
крестьянская община peasant commune (hist); о́бщи́на [either stress]
f
m
одиночный образ жизни solitary lifestyle
оказание помощи assisting
i/p оккупирую
i/p ориентируюсь
p осведомлюсь, осведомишься
печатать/отпечатывать i
p отрекусь, отречёшься, отрекутся, past отрёкся, отреклась
p отрублю, отрубишь
f
p перегоню, перегонишь
p перепишу, перепишешь
i переставляю
i пру, прёшь, past пёр, пёрла
обед на десять персон dinner for ten
f
g pl плясок
g pl повадок
g pl повозок
подача топлива fuel supply; подача помощи assistance
p подброшу, подбросишь
подъёмный кран crane; подъёмный мост drawbridge
p пожую, пожуёшь
p пожгу, пожжёшь, пожгут, past пожёг, пожгла
f помещичья, п помещичье
p понижу, понизишь
i потребляю
i пребывать у власти to be in power
m
припадок гнева fit of anger
m pl; g pl припасов
i присягать в верности to swear an oath of loyalty
пробел в знаниях gap in one’s knowledge
p пробью, пробьёшь
p прогремлю, прогремишь
p прогуляюсь
p продемонстрирую;
p прозову, прозовёшь, f past прозвала
i пропагандирую
p просплю, проспишь, f past проспала
p простужусь, простудишься; простуживаться i or простужаться i
p протянусь, протянешься
no p
nom pl пчёлы
g pl пьянок
nom pl пяты, g pl пят, d pl пятам
p разбегусь, разбежишься, разбегутся
разведывательная служба intelligence service
p развешу, развесишь;развесить бельё to hang out the washing
p разгоню, разгонишь, f past разогнала
p раскушу, раскусишь
p распоряжусь, распорядишься
рассыпа́ться/рассы́паться; p рассыплю, рассыплешь
f
f ребячья, п ребячье
nom pl решёта; Чудеса в решете! Incredible!
рыночная экономика market economy
p сберегу, сбережёшь, сберегут, past сберёг, сберегла
p свешу, свесишь
серийное производство mass production
g sg синяка
f; g pl скорбей
f
i шлю, шлёшь
для красного словца for effect
m; nom pl слуги
смешки jeers, jokes
p снаряжу, снарядишь
i совершенствуюсь
p сооружу, соорудишь
p сопоставлю, сопоставишь
i сопутствую
составление словаря compilation of a dictionary
g pl сосулек
среза́ть/сре́зать; p срежу, срежешь
g pl стачек
i странствую
стрелковый тир rifle range
g pl стружек
g pl стычек
nom pl сукна, g pl сукон
m; g sg сухаря
g sg тайника
g pl тётушек
nom pl (formal) токари, nom pl (coll) токаря
i торжествую
g pl турок
f
i уклоняюсь; уклоняться от ответа to dodge a question, avoid answering
i укреплюсь, укрепишься
универсальный магазин department store
p усею, усеешь
g sg утюга
nom pl цыгане, g pl цыган
f
g четырёхсот
g pl чисток
g pl шахмат
g pl шишек
i шляюсь
f
поm pl щенки, g pl щенков or nom pl щенята, g pl щенят
g pl ярмарок
m
g pl бабочек
g sg багажа
nom pl бёдра, g pl бёдер
i бездействую
g sg бинта
nom pl блохи, g pl блох, d pl блохам
f
m
g pl вилок
p водружу, водрузишь
p воздержусь, воздержишься
i воняет
воочию убедиться в +pr to see for os
nom pl вороха; ворох сена pile of hay; ворох новостей heaps of news
g pl вышек
f
i гнию, гниёшь, f past гнила
g sg горба, pr sg на горбу
f
f
m pl; g pl духов
g sg ежа
pr sg в жиру, nom pl жиры
g sg займа
окончить институт заочно to take an external degree
f
изрядное количество quite a lot
i злоупотребляю
m/f
g sg камыша
soft adj
i клюю, клюёшь; клевать носом to nod, be drowsy
m; g pl когтей
g sg кутежа
g pl лазеек
g pl ласточек
i ликую
i льщу, льстишь
i мажу, мажешь
g sg маяка
f
i мету, метёшь, past мёл, мела
g pl мисок
f
g sg мятежа
выучить наизусть to learn by heart
наперекор судьбе in defiance of fate
g pl невесток
g pl неполадок; неполадки (coll) quarrel
неурядицы squabbling
f ничья, n ничьё; ничья drawn game; ничья земля no man’s land
тихий нрав quiet nature; нравы manners, customs
i ною, ноешь
p обуздаю
m
В тихом омуте черти водятся Still waters run deep
g pl опилок
f
p легко отделаться to get off lightly
i отравляю
p ошеломлю, ошеломишь
f
g pl пелёнок
g pl передышек
m
pr sg в/на пиру, nom pl пиры
i пищу, пищишь
i плещу, плещешь
f
p побужу, побудишь
i покоряю
g/d/inst/pr полутораста
g pl поместий
i поощряю
с грехом пополам after а fashion, only just
nom pl поросята, g pl поросят
i поставляю
быть с похмелья to have а hangover
f
православная церковь Orthodox Church
f
пресная вода fresh water
g sg пруда, pr sg в пруду
pr sg в пуху
pr sg в пылу
разительное сходство striking similarity
разрозненный комплект broken set; разрозненные выстрелы isolated shots
раскат грома rumble of thunder; раскаты хохота loud peals of laughter
голос рассудка the voice of reason; лишиться рассудка to go out of one’s mind
no i
f
g pl селёдок; dim of сельдь f herring
g sg сквозняка
nom pl скорлупы; яичная скорлупа eggshell
i слыву, слывёшь; Он слывёт чудаком Не is considered eccentric
also in the form слюни pl, g pl слюней
смежные комнаты adjoining rooms
p сомну, сомнёшь
i сную, снуёшь
Необходимо иметь сноровку You have to have the knack
g sg соловья, g pl Соловьёв
f pl; nom sg сплетня; g pl сплетен
производственный стаж industrial experience
p сшибу, сшибёшь, past сшиб, сшибла; сшибить кого-нибудь с ног to knock s.o. off their feet
pr sg в тазу or в тазе, nom pl тазы
i тлеет
no pl
по вашему усмотрению as you think best
g pl утечек
i ухмыляюсь
g pl хлопьев
i чешу, чешешь
i чту, чтишь
i шаркать ногами to shuffle one’s feet
g sg шнура
m; nom pl штабеля
i щекочу, щекочешь
g pl электричек
g pl этажерок
ярый поклонник fervent admirer
